						
彼はスーパーで果物を買う。	(かれはすーぱーでくだものをかう。)<br>He buys fruit at the supermarket.<br>(Present Positive Plain of 買う)<br>(C1)<br>	[soundfile]
彼は毎日コンビニでお菓子を買わない。	(かれはまいにちこんびにでおかしをかわない。)<br>He doesn't buy snacks at the convenience store every day.<br>(Present Negative Plain of 買う)<br>(C1)<br>	[soundfile]
彼女は市場で新鮮な魚を買います。	(かのじょはいちばでしんせんなさかなをかいます。)<br>She buys fresh fish at the market.<br>(Present Positive Polite of 買う)<br>(C1)<br>	[soundfile]
私は今日は何も買いません。	(わたしはきょうはなにもかいません。)<br>I won't buy anything today.<br>(Present Negative Polite of 買う)<br>(C1)<br>	[soundfile]
昨日、彼らは新しい車を買った。	(きのう、かれらはあたらしいくるまをかった。)<br>Yesterday, they bought a new car.<br>(Past Positive Plain of 買う)<br>(C1)<br>	[soundfile]
彼は先週、本を買わなかった。	(かれはせんしゅう、ほんをかわなかった。)<br>He didn't buy a book last week.<br>(Past Negative Plain of 買う)<br>(C1)<br>	[soundfile]
彼女は昨日、お土産を買いました。	(かのじょはきのう、おみやげをかいました。)<br>She bought souvenirs yesterday.<br>(Past Positive Polite of 買う)<br>(C1)<br>	[soundfile]
その店で靴を買いませんでした。	(そのみせでくつをかいませんでした。)<br>I didn't buy shoes at that store.<br>(Past Negative Polite of 買う)<br>(C1)<br>	[soundfile]
友達と一緒に服を買ってきた。	(ともだちといっしょにふくをかってきた。)<br>I bought clothes with my friend.<br>(-te Form of 買う)<br>(C1)<br>	[soundfile]
これから本を買おうと思います。	(これからほんをかおうとおもいます。)<br>I'm going to buy a book from now on.<br>(Volitional of 買う)<br>(C1)<br>	[soundfile]
この店ではクレジットカードで買える。	(このみせではくれじっとかーどでかえる。)<br>You can buy with a credit card at this store.<br>(Potential of 買う)<br>(C1)<br>	[soundfile]
その商品はオンラインで買われました。	(そのしょうひんはおんらいんでかわれました。)<br>The product was bought online.<br>(Passive of 買う)<br>(C1)<br>	[soundfile]
私の兄は私に新しい自転車を買わせてくれました。	(わたしのあにはわたしにあたらしいじてんしゃをかわせてくれました。)<br>My brother let me buy a new bicycle.<br>(Causative of 買う)<br>(C1)<br>	[soundfile]
早く行って、水を買え！	(はやくいって、みずをかえ！)<br>Go quickly and buy some water!<br>(Imperative of 買う)<br>(C1)<br>	[soundfile]
お金があれば、新しいスマートフォンを買えばいいですね。	(おかねがあれば、あたらしいすまーとふぉんをかえばいいですね。)<br>If you have money, it would be good to buy a new smartphone, wouldn't it?<br>(Conditional of 買う)<br>(C1)<br>	[soundfile]
彼は未来を明るく思う。	(かれはみらいをあかるくおもう。)<br>He thinks brightly about the future.<br>(Present Positive Plain of 思う)<br>(C2)<br>	[soundfile]
私は彼がそんなことをするとは思わない。	(わたしはかれがそんなことをするとはおもわない。)<br>I don't think he would do such a thing.<br>(Present Negative Plain of 思う)<br>(C2)<br>	[soundfile]
彼女はいつも友達を思います。	(かのじょはいつもともだちをおもいます。)<br>She always thinks about her friends.<br>(Present Positive Polite of 思う)<br>(C2)<br>	[soundfile]
彼はその計画が失敗するとは思いませんでした。	(かれはそのけいかくがしっぱいするとはおもいませんでした。)<br>He didn't think the plan would fail.<br>(Present Negative Polite of 思う)<br>(C2)<br>	[soundfile]
私は彼が来ると思った。	(わたしはかれがくるとおもった。)<br>I thought he would come.<br>(Past Positive Plain of 思う)<br>(C2)<br>	[soundfile]
彼は彼女がそんなに怒るとは思わなかった。	(かれはかのじょがそんなにおこるとはおもわなかった。)<br>He didn't think she would get so angry.<br>(Past Negative Plain of 思う)<br>(C2)<br>	[soundfile]
私はその映画がとても面白いと思いました。	(わたしはそのえいががとてもおもしろいとおもいました。)<br>I thought the movie was very interesting.<br>(Past Positive Polite of 思う)<br>(C2)<br>	[soundfile]
彼女は彼の言葉を真剣に受け取らなかったと思いませんでした。	(かのじょはかれのことばをしんけんにうけとらなかったとおもいませんでした。)<br>She didn't take his words seriously.<br>(Past Negative Polite of 思う)<br>(C2)<br>	[soundfile]
彼は何も言わずに出て行ってしまったと思っていました。	(かれはなにもいわずにでていってしまったとおもっていました。)<br>I thought he left without saying anything.<br>(-te Form of 思う)<br>(C2)<br>	[soundfile]
この問題について一緒に解決しようと思います。	(このもんだいについていっしょにかいけつしようとおもいます。)<br>Let's try to solve this problem together.<br>(Volitional of 思う)<br>(C2)<br>	[soundfile]
彼女の言葉はとても説得力があって、本当だと思える。	(かのじょのことばはとてもせっとくりょくがあって、ほんとうだとおもえる。)<br>Her words are very convincing and seem true.<br>(Potential of 思う)<br>(C2)<br>	[soundfile]
彼の行動はみんなに賞賛されて思われる。	(かれのこうどうはみんなにしょうさんされておもわれる。)<br>His actions are admired by everyone.<br>(Passive of 思う)<br>(C2)<br>	[soundfile]
彼は私に自分の未来を真剣に考えさせた。	(かれはわたしにじぶんのみらいをしんけんにかんがえさせた。)<br>He made me seriously consider my future.<br>(Causative of 思う)<br>(C2)<br>	[soundfile]
この決定についてもう一度よく考えてみてください。	(このけっていについてもういちどよくかんがえてみてください。)<br>Please think carefully about this decision again.<br>(Imperative of 思う)<br>(C2)<br>	[soundfile]
もっと早く相談していれば、問題は解決できたかもしれないと思えば後悔する。	(もっとはやくそうだんしていれば、もんだいはかいけつできたかもしれないとおもえばこうかいする。)<br>I regret thinking that if I had consulted earlier, the problem might have been solved.<br>(Conditional of 思う)<br>(C2)<br>	[soundfile]
彼はいつも正直に言います。	(かれはいつもしょうじきにいいます。)<br>He always speaks honestly.<br>(Present Positive Plain of 言う)<br>(C3)<br>	[soundfile]
彼女は怒っている時は何も言わない。	(かのじょはおこっているときはなにもいわない。)<br>She doesn't say anything when she's angry.<br>(Present Negative Plain of 言う)<br>(C3)<br>	[soundfile]
先生は生徒に常に励ましの言葉を言います。	(せんせいはせいとにつねにはげましのことばをいいます。)<br>The teacher always says words of encouragement to the students.<br>(Present Positive Polite of 言う)<br>(C3)<br>	[soundfile]
彼は彼女の秘密を誰にも言いませんでした。	(かれはかのじょのひみつをだれにもいいませんでした。)<br>He didn't tell anyone about her secret.<br>(Present Negative Polite of 言う)<br>(C3)<br>	[soundfile]
彼は彼女に愛してると言った。	(かれはかのじょにあいしてるといった。)<br>He said he loves her.<br>(Past Positive Plain of 言う)<br>(C3)<br>	[soundfile]
彼はその計画に賛成したが言わなかった。	(かれはそのけいかくにさんせいしたがいわなかった。)<br>He agreed with the plan but didn't say it.<br>(Past Negative Plain of 言う)<br>(C3)<br>	[soundfile]
彼女は私に謝罪の言葉を言いました。	(かのじょはわたしにしゃざいのことばをいいました。)<br>She apologized to me.<br>(Past Positive Polite of 言う)<br>(C3)<br>	[soundfile]
私はその時、何も言いませんでした。	(わたしはそのとき、なにもいいませんでした。)<br>I didn't say anything at that time.<br>(Past Negative Polite of 言う)<br>(C3)<br>	[soundfile]
彼は急いで家を出て行くとき、何も言っていませんでした。	(かれはいそいでいえをでていくとき、なにもいっていませんでした。)<br>He didn't say anything when he hurried out of the house.<br>(-te Form of 言う)<br>(C3)<br>	[soundfile]
この問題について話し合って、解決しようと言おう。	(このもんだいについてはなしあって、かいけつしようといおう。)<br>Let's discuss this issue and try to resolve it.<br>(Volitional of 言う)<br>(C3)<br>	[soundfile]
彼は英語と日本語を話せる。	(かれはえいごとにほんごをはなせる。)<br>He can speak English and Japanese.<br>(Potential of 言う)<br>(C3)<br>	[soundfile]
私は先生に叱られた。	(わたしはせんせいにしかられた。)<br>I was scolded by the teacher.<br>(Passive of 言う)<br>(C3)<br>	[soundfile]
彼は私に彼女の気持ちを素直に言わせた。	(かれはわたしにかのじょのきもちをすなおにいわせた。)<br>He made me speak honestly about her feelings.<br>(Causative of 言う)<br>(C3)<br>	[soundfile]
本当のことを言え！	(ほんとうのことをいえ！)<br>Tell the truth!<br>(Imperative of 言う)<br>(C3)<br>	[soundfile]
早く彼に謝れば、もっと上手くいくかもしれない。	(はやくかれにあやまれば、もっとじょうずくいくかもしれない。)<br>If you apologize to him quickly, it might go more smoothly.<br>(Conditional of 言う)<br>(C3)<br>	[soundfile]
私は毎日コーヒーを飲む。	(わたしはまいにちこーひーをのむ。)<br>I drink coffee every day.<br>(Present Positive Plain of 飲む)<br>(A1)<br>	[soundfile]
彼はアルコールを飲まない。	(かれはあるこーるをのまない。)<br>He doesn't drink alcohol.<br>(Present Negative Plain of 飲む)<br>(A1)<br>	[soundfile]
彼女は夜にワインを飲みます。	(かのじょはよるにわいんをのみます。)<br>She drinks wine at night.<br>(Present Positive Polite of 飲む)<br>(A1)<br>	[soundfile]
私は炭酸飲料を普段あまり飲みません。	(わたしはたんさんいんりょうをふだんあまりのみません。)<br>I don't usually drink carbonated beverages.<br>(Present Negative Polite of 飲む)<br>(A1)<br>	[soundfile]
昨日、彼らはお茶をたくさん飲んだ。	(きのう、かれらはおちゃをたくさんのんだ。)<br>Yesterday, they drank a lot of tea.<br>(Past Positive Plain of 飲む)<br>(A1)<br>	[soundfile]
私は昨日、コーヒーを飲まなかった。	(わたしはきのう、こーひーをのまなかった。)<br>I didn't drink coffee yesterday.<br>(Past Negative Plain of 飲む)<br>(A1)<br>	[soundfile]
彼は昨夜、ビールを一杯飲みました。	(かれはさくや、びーるをいっぱいのみました。)<br>He drank a glass of beer last night.<br>(Past Positive Polite of 飲む)<br>(A1)<br>	[soundfile]
私は昨日、お酒を一滴も飲みませんでした。	(わたしはきのう、おさけをいってきものものみませんでした。)<br>I didn't drink a drop of alcohol yesterday.<br>(Past Negative Polite of 飲む)<br>(A1)<br>	[soundfile]
友達と一緒にカフェでコーヒーを飲んできた。	(ともだちといっしょにかふぇでこーひーをのんできた。)<br>I came back after drinking coffee at the cafe with my friends.<br>(-te Form of 飲む)<br>(A1)<br>	[soundfile]
暑いから、冷たい水を飲もう。	(あついから、つめたいみずをのもう。)<br>It's hot, so let's drink cold water.<br>(Volitional of 飲む)<br>(A1)<br>	[soundfile]
その薬は水で飲めるようにしてください。	(そのくすりはみずでのめるようにしてください。)<br>Please make that medicine drinkable with water.<br>(Potential of 飲む)<br>(A1)<br>	[soundfile]
彼は健康ドリンクを毎日飲まれています。	(かれはけんこうどりんくをまいにちのまれています。)<br>He drinks health drinks every day.<br>(Passive of 飲む)<br>(A1)<br>	[soundfile]
母は私に薬を飲ませてくれました。	(はははわたしにくすりをのませてくれました。)<br>My mother made me take medicine.<br>(Causative of 飲む)<br>(A1)<br>	[soundfile]
毎日水をたくさん飲め！	(まいにちみずをたくさんのめ！)<br>Drink plenty of water every day!<br>(Imperative of 飲む)<br>(A1)<br>	[soundfile]
お腹がすいたら、水を飲めばいいですよ。	(おなかがすいたら、みずをのめばいいですよ。)<br>If you're hungry, it's good to drink water.<br>(Conditional of 飲む)<br>(A1)<br>	[soundfile]
彼は口にチューインガムを含む。	(かれはくちにちゅーいんがむをふくむ。)<br>He includes chewing gum in his mouth.<br>(Present Positive Plain of 含む)<br>(A2)<br>	[soundfile]
この製品には添加物は含まない。	(このせいひんにはてんかぶつはふくまない。)<br>This product does not contain additives.<br>(Present Negative Plain of 含む)<br>(A2)<br>	[soundfile]
この飲み物には果汁が含みます。	(こののみものにはかじゅうがふくまれます。)<br>This drink contains fruit juice.<br>(Present Positive Polite of 含む)<br>(A2)<br>	[soundfile]
この製品にはアレルギーの原因物質は含みません。	(このせいひんにはあれるぎーのげんいんぶっしつはふくません。)<br>This product does not contain allergens.<br>(Present Negative Polite of 含む)<br>(A2)<br>	[soundfile]
彼はその話の中に意味深なメッセージを含んだ。	(かれはそのはなしのなかにいみぶかいメッセージをふくんだ。)<br>He included a meaningful message in the story.<br>(Past Positive Plain of 含む)<br>(A2)<br>	[soundfile]
彼女はその本の著者に感情を含まなかった。	(かのじょはそのほんのちょしゃにかんじょうをふくまなかった。)<br>She didn't include emotions to the author of that book.<br>(Past Negative Plain of 含む)<br>(A2)<br>	[soundfile]
その料理にはたくさんの栄養素が含みました。	(そのりょうりにはたくさんのえいようそがふくみました。)<br>The dish contained a lot of nutrients.<br>(Past Positive Polite of 含む)<br>(A2)<br>	[soundfile]
彼の話には事実が含まれていなかった。	(かれのはなしにはじじつがふくまれていませんでした。)<br>The truth was not included in his story.<br>(Past Negative Polite of 含む)<br>(A2)<br>	[soundfile]
その薬は水でよく溶かして含んで飲んでください。	(そのくすりはみずでよくとかしてふくんでのんでください。)<br>Please dissolve that medicine well in water and drink it.<br>(-te Form of 含む)<br>(A2)<br>	[soundfile]
この話題は議論を含もうとしている。	(このわだいはぎろんをふくもうとしている。)<br>This topic is trying to include a discussion.<br>(Volitional of 含む)<br>(A2)<br>	[soundfile]
このスープには新鮮な野菜を含めるべきです。	(このすーぷにはしんせんなやさいをふくめるべきです。)<br>Fresh vegetables should be included in this soup.<br>(Potential of 含む)<br>(A2)<br>	[soundfile]
この商品には天然成分が含まれています。	(このしょうひんにはてんねんせいぶんがふくまれています。)<br>This product contains natural ingredients.<br>(Passive of 含む)<br>(A2)<br>	[soundfile]
彼は私たちに彼の秘密を含ませた。	(かれはわたしたちにかれのひみつをふくませた。)<br>He made us include his secret.<br>(Causative of 含む)<br>(A2)<br>	[soundfile]
このプロジェクトにはチーム全員を含めてください。	(このぷろじぇくとにはちーむぜんいんをふくめてください。)<br>Please include the entire team in this project.<br>(Imperative of 含む)<br>(A2)<br>	[soundfile]
努力を含めれば、成功はもっと近づくかもしれません。	(どりょくをふくめれば、せいこうはもっとちかづくかもしれません。)<br>Including effort, success may be closer.<br>(Conditional of 含む)<br>(A2)<br>	[soundfile]
彼は東京に住んでいます。	(かれはとうきょうにすんでいます。)<br>He lives in Tokyo.<br>(Present Positive Plain of 住む)<br>(A3)<br>	[soundfile]
私は田舎に住まない。	(わたしはいなかにすまない。)<br>I don't live in the countryside.<br>(Present Negative Plain of 住む)<br>(A3)<br>	[soundfile]
私たちはこのアパートに住みます。	(わたしたちはこのあぱーとにすみます。)<br>We live in this apartment.<br>(Present Positive Polite of 住む)<br>(A3)<br>	[soundfile]
彼女は大都市に住みません。	(かのじょはだいとしにすみません。)<br>She doesn't live in a big city.<br>(Present Negative Polite of 住む)<br>(A3)<br>	[soundfile]
私は昔、京都に住んだことがあります。	(わたしはむかし、きょうとにすんだことがあります。)<br>I used to live in Kyoto.<br>(Past Positive Plain of 住む)<br>(A3)<br>	[soundfile]
彼はその町に住まなかった。	(かれはそのまちにすまなかった。)<br>He didn't live in that town.<br>(Past Negative Plain of 住む)<br>(A3)<br>	[soundfile]
私の祖父は昔、海辺に住みました。	(わたしのそふはむかし、うみべにすみました。)<br>My grandfather used to live by the sea.<br>(Past Positive Polite of 住む)<br>(A3)<br>	[soundfile]
彼らはその家に住みませんでした。	(かれらはそのいえにすみませんでした。)<br>They didn't live in that house.<br>(Past Negative Polite of 住む)<br>(A3)<br>	[soundfile]
私たちは新しい町に引っ越して住んでいます。	(わたしたちはあたらしいまちにひっこしてすんでいます。)<br>We moved to a new town and are living there.<br>(-te Form of 住む)<br>(A3)<br>	[soundfile]
この地域に永住しようと思っています。	(このちいきにえいじゅうしようとおもっています。)<br>I'm thinking of settling down in this area.<br>(Volitional of 住む)<br>(A3)<br>	[soundfile]
この地域ではペットを飼うことが許可されているので、住める。	(このちいきではぺっとをかうことがきょかされているので、すめる。)<br>Pets are allowed in this area, so you can live here.<br>(Potential of 住む)<br>(A3)<br>	[soundfile]
この町は住みやすいとよく住まれています。	(このまちはすみやすいとよくすまれています。)<br>This town is often lived in because it's easy to live in.<br>(Passive of 住む)<br>(A3)<br>	[soundfile]
彼は子供たちを安全な場所に住ませたいと思っています。	(かれはこどもたちをあんぜんなばしょにすませたいとおもっています。)<br>He wants to make sure the children live in a safe place.<br>(Causative of 住む)<br>(A3)<br>	[soundfile]
この町は景色が素晴らしいので、ここに住め！	(このまちはけしきがすばらしいので、ここにすめ！)<br>The scenery in this town is wonderful, so live here!<br>(Imperative of 住む)<br>(A3)<br>	[soundfile]
この地域に住めば、自然に触れ合う機会が増えます。	(このちいきにすめば、しぜんにふれあうきかいがふえます。)<br>If you live in this area, you'll have more opportunities to interact with nature.<br>(Conditional of 住む)<br>(A3)<br>	[soundfile]
私は朝食に卵を食べる。	(わたしはちょうしょくにたまごをたべる。)<br>I eat eggs for breakfast.<br>(Present Positive Plain of 食べる)<br>(B1)<br>	[soundfile]
彼は肉を食べない。	(かれはにくをたべない。)<br>He doesn't eat meat.<br>(Present Negative Plain of 食べる)<br>(B1)<br>	[soundfile]
彼女は毎日フルーツを食べます。	(かのじょはまいにちふるーつをたべます。)<br>She eats fruit every day.<br>(Present Positive Polite of 食べる)<br>(B1)<br>	[soundfile]
私は夜遅くには何も食べません。	(わたしはよるおそくにはなにもたべません。)<br>I don't eat anything late at night.<br>(Present Negative Polite of 食べる)<br>(B1)<br>	[soundfile]
昨日、彼らは寿司を食べた。	(きのう、かれらはすしをたべた。)<br>Yesterday, they ate sushi.<br>(Past Positive Plain of 食べる)<br>(B1)<br>	[soundfile]
彼は昨日朝食を食べなかった。	(かれはきのうちょうしょくをたべなかった。)<br>He didn't eat breakfast yesterday.<br>(Past Negative Plain of 食べる)<br>(B1)<br>	[soundfile]
彼女は昨夜、ケーキを一つ食べました。	(かのじょはさくや、けーきをひとつたべました。)<br>She ate a piece of cake last night.<br>(Past Positive Polite of 食べる)<br>(B1)<br>	[soundfile]
彼は昨日、仕事中何も食べませんでした。	(かれはきのう、しごとちゅうなにもたべませんでした。)<br>He didn't eat anything during work yesterday.<br>(Past Negative Polite of 食べる)<br>(B1)<br>	[soundfile]
友達と一緒に外でランチを食べてきた。	(ともだちといっしょにそとでらんちをたべてきた。)<br>I ate lunch outside with my friends.<br>(-te Form of 食べる)<br>(B1)<br>	[soundfile]
今日は美味しい料理を食べようと思っています。	(きょうはおいしいりょうりをたべようとおもっています。)<br>I'm thinking of eating delicious food today.<br>(Volitional of 食べる)<br>(B1)<br>	[soundfile]
この料理は辛いけど、食べられます。	(このりょうりはからいけど、たべられます。)<br>This dish is spicy, but I can eat it.<br>(Potential of 食べる)<br>(B1)<br>	[soundfile]
その料理はお客様に好評で、よく食べられます。	(そのりょうりはおきゃくさまにこうひょうで、よくたべられます。)<br>That dish is well-received by customers and is often eaten.<br>(Passive of 食べる)<br>(B1)<br>	[soundfile]
彼は私に新しい料理を試してみせて、食べさせた。	(かれはわたしにあたらしいりょうりをためしてみせて、たべさせた。)<br>He let me try the new dish and made me eat it.<br>(Causative of 食べる)<br>(B1)<br>	[soundfile]
もっと野菜を食べろ！	(もっとやさいをたべろ！)<br>Eat more vegetables!<br>(Imperative of 食べる)<br>(B1)<br>	[soundfile]
よく噛んで食べれば、胃に負担がかからない。	(よくかんでたべれば、いにふたんがかからない。)<br>If you chew your food well, it won't burden your stomach.<br>(Conditional of 食べる)<br>(B1)<br>	[soundfile]
彼は毎晩テレビを見る。	(かれはまいばんてれびをみる。)<br>He watches TV every night.<br>(Present Positive Plain of 見る)<br>(B2)<br>	[soundfile]
私はその映画をまだ見ない。	(わたしはそのえいがをまだみない。)<br>I haven't seen that movie yet.<br>(Present Negative Plain of 見る)<br>(B2)<br>	[soundfile]
彼女は週末によく映画を見ます。	(かのじょはしゅうまつによくえいがをみます。)<br>She often watches movies on weekends.<br>(Present Positive Polite of 見る)<br>(B2)<br>	[soundfile]
私は暗いところではよく見ません。	(わたしはくらいところではよくみません。)<br>I don't see well in dark places.<br>(Present Negative Polite of 見る)<br>(B2)<br>	[soundfile]
私は昨日、新しい展示を見た。	(わたしはきのう、あたらしいてんじをみた。)<br>I saw the new exhibition yesterday.<br>(Past Positive Plain of 見る)<br>(B2)<br>	[soundfile]
彼はその映画を昨日見なかった。	(かれはそのえいがをきのうみなかった。)<br>He didn't see that movie yesterday.<br>(Past Negative Plain of 見る)<br>(B2)<br>	[soundfile]
私たちは先週、美術館で素晴らしい絵を見ました。	(わたしたちはせんしゅう、びじゅつかんですばらしいえをみました。)<br>We saw wonderful paintings at the art museum last week.<br>(Past Positive Polite of 見る)<br>(B2)<br>	[soundfile]
彼女は昨日、テレビを見ませんでした。	(かのじょはきのう、てれびをみませんでした。)<br>She didn't watch TV yesterday.<br>(Past Negative Polite of 見る)<br>(B2)<br>	[soundfile]
雨が降っているので、窓から外を見ています。	(あめがふっているので、まどからそとをみています。)<br>It's raining, so I'm looking outside from the window.<br>(-te Form of 見る)<br>(B2)<br>	[soundfile]
明日はいい映画を見よう。	(あしたはいいえいがをみよう。)<br>Let's watch a good movie tomorrow.<br>(Volitional of 見る)<br>(B2)<br>	[soundfile]
彼は遠くの山々を見られる。	(かれはとおくのやまやまをみられる。)<br>He can see the distant mountains.<br>(Potential of 見る)<br>(B2)<br>	[soundfile]
その映画は多くの人に見られました。	(そのえいがはおおくのひとにみられました。)<br>The movie was seen by many people.<br>(Passive of 見る)<br>(B2)<br>	[soundfile]
先生は私たちに新しい技術を見させた。	(せんせいはわたしたちにあたらしいぎじゅつをみさせた。)<br>The teacher made us see the new technology.<br>(Causative of 見る)<br>(B2)<br>	[soundfile]
その方向に行ってみろ！	(そのほうこうにいってみろ！)<br>Go in that direction and see!<br>(Imperative of 見る)<br>(B2)<br>	[soundfile]
天気予報を見れば、明日は晴れるかどうかわかる。	(てんきよほうをみれば、あしたははれるかどうかわかる。)<br>If you check the weather forecast, you'll know whether it will be sunny tomorrow.<br>(Conditional of 見る)<br>(B2)<br>	[soundfile]
彼は古典的な方法を用いる。	(かれはこてんてきなほうほうをもちいる。)<br>He uses traditional methods.<br>(Present Positive Plain of 用いる)<br>(B3)<br>	[soundfile]
このプロジェクトでは最新の技術を用いない。	(このぷろじぇくとではさいしんのぎじゅつをもちいない。)<br>We don't use the latest technology in this project.<br>(Present Negative Plain of 用いる)<br>(B3)<br>	[soundfile]
私たちはこのアプリを日常的に用います。	(わたしたちはこのあぷりをにちじょうてきにもちいます。)<br>We use this app on a daily basis.<br>(Present Positive Polite of 用いる)<br>(B3)<br>	[soundfile]
彼女は伝統的な手法を用いません。	(かのじょはでんとうてきなしゅほうをもちいません。)<br>She doesn't use traditional methods.<br>(Present Negative Polite of 用いる)<br>(B3)<br>	[soundfile]
私は昨日、新しいプログラムを用いた。	(わたしはきのう、あたらしいぷろぐらむをもちいた。)<br>I used a new program yesterday.<br>(Past Positive Plain of 用いる)<br>(B3)<br>	[soundfile]
その会社は以前、このシステムを用いなかった。	(そのかいしゃはいぜん、このしすてむをもちいなかった。)<br>The company didn't use this system before.<br>(Past Negative Plain of 用いる)<br>(B3)<br>	[soundfile]
この方法を用いましたが、うまくいきませんでした。	(このほうほうをもちいましたが、うまくいきませんでした。)<br>We used this method, but it didn't work well.<br>(Past Positive Polite of 用いる)<br>(B3)<br>	[soundfile]
そのプロジェクトでは、その技術を用いませんでした。	(そのぷろじぇくとでは、そのぎじゅつをもちいませんでした。)<br>We didn't use that technology in the project.<br>(Past Negative Polite of 用いる)<br>(B3)<br>	[soundfile]
この資料を用いて報告書を作成しました。	(このしりょうをもちいてほうこくしょをさくせいしました。)<br>I used this document to create the report.<br>(-te Form of 用いる)<br>(B3)<br>	[soundfile]
新しい手法を用おうとしています。	(あたらしいしゅほうをもちおうとしています。)<br>I'm trying to use a new method.<br>(Volitional of 用いる)<br>(B3)<br>	[soundfile]
この道具は様々な目的に用えることができます。	(このどうぐはさまざまなもくてきにもえることができます。)<br>This tool can be used for various purposes.<br>(Potential of 用いる)<br>(B3)<br>	[soundfile]
このアプリは広く用われています。	(このあぷりはひろくもちわれています。)<br>This app is widely used.<br>(Passive of 用いる)<br>(B3)<br>	[soundfile]
先生は生徒たちに自分の言葉を用わせる。	(せんせいはせいとたちにじぶんのことばをもちわせる。)<br>The teacher makes the students use their own words.<br>(Causative of 用いる)<br>(B3)<br>	[soundfile]
その機能を用いろ！	(そのきのうをもちいろ！)<br>Use that feature!<br>(Imperative of 用いる)<br>(B3)<br>	[soundfile]
適切に資源を用えば、より効率的になります。	(てきせつにしげんをもえば、よりこうりつてきになります。)<br>Using resources properly will make it more efficient.<br>(Conditional of 用いる)<br>(B3)<br>	[soundfile]
行く(D1)	行く	彼は毎朝ジョギングに行く。	(かれはまいあさじょぎんぐにいく。)	He goes jogging every morning.		Present Positive Plain
行く(D1)	行かない	彼女は雨の日には外出しない。	(かのじょはあめのひにはがいしゅつしない。)	She doesn't go out on rainy days.		Present Negative Plain
行く(D1)	行きます	私たちは今晩映画を見に行きます。	(わたしたちはこんばんえいがをみにいきます。)	We are going to see a movie tonight.		Present Positive Polite
行く(D1)	行きません	この週末は旅行には行きません。	(このしゅうまつはりょこうにはいきません。)	I'm not going on a trip this weekend.		Present Negative Polite
行く(D1)	行った	先週、友達と海へ行った。	(せんしゅう、ともだちとうみへいった。)	I went to the beach with my friends last week.		Past Positive Plain
行く(D1)	行かなかった	彼は昨日、授業に行かなかった。	(かれはきのう、じゅぎょうにいかなかった。)	He didn't go to class yesterday.		Past Negative Plain
行く(D1)	行きました	彼女は昨夜、コンサートに行きました。	(かのじょはさくや、こんさーとにいきました。)	She went to the concert last night.		Past Positive Polite
行く(D1)	行きませんでした	私たちは先週末、野外コンサートに行きませんでした。	(わたしたちはせんしゅうまつ、やがいこんさーとにいきませんでした。)	We didn't go to the outdoor concert last weekend.		Past Negative Polite
行く(D1)	行って	彼らは映画館に行ってきた。	(かれらはえいがかんにいってきた。)	They went to the movie theater.		-te Form
行く(D1)	行こう	明日は公園にピクニックしに行こう。	(あしたはこうえんにぴくにっくしにいこう。)	Let's go to the park for a picnic tomorrow.		Volitional
行く(D1)	行ける	彼は一人で外国に行ける。	(かれはひとりでがいこくにいける。)	He can go abroad alone.		Potential
行く(D1)	行かれる	その会社では、定期的に海外出張が行かれる。	(そのかいしゃでは、ていきてきにかいがいしゅっちょうがいかれる。)	In that company, regular overseas business trips are made.		Passive
行く(D1)	行かせる	両親は子供たちを映画館に行かせた。	(りょうしんはこどもたちをえいがかんにいかせた。)	The parents made the children go to the movie theater.		Causative
行く(D1)	行け	早く行け！	(はやくいけ！)	Go quickly!		Imperative
行く(D1)	行けば	もし天気が良ければ、散歩に行けばどうですか？	(もしてんきがよければ、さんぽにいけばどうですか？)	If the weather is good, how about going for a walk?		Conditional
往く(D2)	往く	彼は毎年夏に祖国へ往く。	(かれはまいとしなつにそこくへゆく。)	He goes back to his homeland every summer.		Present Positive Plain
往く(D2)	往かない	彼女は町から出ずに往かない。	(かのじょはまちからいずにいかない。)	She doesn't venture out of town.		Present Negative Plain
往く(D2)	往きます	彼は出張のために東京へ往きます。	(かれはしゅっちょうのためにとうきょうへいきます。)	He travels to Tokyo for business.		Present Positive Polite
往く(D2)	往きません	今日は用事があって出かけないので、外には往きません。	(きょうはようじがあってでかけないので、そとにはいきません。)	I won't go outside today because I have errands to run.		Present Negative Polite
往く(D2)	往いた	私は昨日、彼の家へ往いた。	(わたしはきのう、かれのいえへゆいた。)	I went to his house yesterday.		Past Positive Plain
往く(D2)	往かなかった	彼は昨日、予定が変わって出かけなかったので、祭りへ往かなかった。	(かれはきのう、よていがかわってでかけなかったので、まつりへいかなかった。)	He didn't go to the festival yesterday because his plans changed and he didn't go out.		Past Negative Plain
往く(D2)	往きました	先月、京都へ往きました。	(せんげつ、きょうとへいきました。)	I went to Kyoto last month.		Past Positive Polite
往く(D2)	往きませんでした	その日は雨だったので、公園へ往きませんでした。	(そのひはあめだったので、こうえんへいきませんでした。)	It was raining that day, so I didn't go to the park.		Past Negative Polite
往く(D2)	往いて	神社へお参りに往いて、お守りを買いました。	(じんじゃへおまいりにゆいて、おまもりをかいました。)	I went to the shrine to pray and bought a protective charm.		-te Form
往く(D2)	往こう	明日は山へ往こうと思っています。	(あしたはやまへいこうとおもっています。)	I'm thinking of going to the mountains tomorrow.		Volitional
往く(D2)	往ける	彼は自由に世界中を往ける。	(かれはじゆうにせかいじゅうをゆける。)	He can travel freely around the world.		Potential
往く(D2)	往かれる	その地域は多くの観光客によって訪れられている。	(そのちいきはおおくのかんこうきゃくによっておとずれられている。)	That area is visited by many tourists.		Passive
往く(D2)	往かせる	彼は子供たちを危険な場所へは往かせない。	(かれはこどもたちをきけんなばしょへはいかせない。)	He doesn't let the children go to dangerous places.		Causative
往く(D2)	往け	旅立ちの時が来たら、新しい冒険に往け！	(たびだちのときがきたら、あたらしいぼうけんにいけ！)	When the time for departure comes, go on a new adventure!		Imperative
往く(D2)	往けば	大学が近くにあれば、自転車で往けばいいですね。	(だいがくがちかくにあれば、じてんしゃでいけばいいですね。)	If the university is nearby, it would be good to go by bike.		Conditional
友達と遊びにイくんだ。	(ともだちとあそびにいくんだ。)<br>I'm going to play with my friends.<br>(Present Positive Plain of イく)<br>(D3)<br>	[soundfile]
彼は今夜は家にイかん。	(かれはこんやはいえにいかん。)<br>He won't go home tonight.<br>(Present Negative Plain of イく)<br>(D3)<br>	[soundfile]
私は明日、映画を見にイきます。	(わたしはあした、えいがをみにいきます。)<br>I will go see a movie tomorrow.<br>(Present Positive Polite of イく)<br>(D3)<br>	[soundfile]
今晩は出かける予定はありませんので、イきません。	(こんばんはでかけるよていはありませんので、いきません。)<br>I won't go out tonight as I have no plans.<br>(Present Negative Polite of イく)<br>(D3)<br>	[soundfile]
先週、友達と遊びにイった。	(せんしゅう、ともだちとあそびにいった。)<br>I went to play with my friends last week.<br>(Past Positive Plain of イく)<br>(D3)<br>	[soundfile]
彼は昨日、運動場にイかんかった。	(かれはきのう、うんどうじょうにいかんかった。)<br>He didn't go to the playground yesterday.<br>(Past Negative Plain of イく)<br>(D3)<br>	[soundfile]
先月、旅行にイきました。	(せんげつ、りょこうにいきました。)<br>I went on a trip last month.<br>(Past Positive Polite of イく)<br>(D3)<br>	[soundfile]
その日は用事があって出かけませんでしたので、公園にイきませんでした。	(そのひはようじがあってでかけませんでしたので、こうえんにいきませんでした。)<br>I didn't go to the park that day as I had errands to run and didn't go out.<br>(Past Negative Polite of イく)<br>(D3)<br>	[soundfile]
ランチを食べにイってきます。	(らんちをたべにいってきます。)<br>I'm going to have lunch.<br>(-te Form of イく)<br>(D3)<br>	[soundfile]
明日は海にイこう。	(あしたはうみにいこう。)<br>Let's go to the beach tomorrow.<br>(Volitional of イく)<br>(D3)<br>	[soundfile]
彼は一人で旅行にイける。	(かれはひとりでりょこうにいける。)<br>He can go on a trip alone.<br>(Potential of イく)<br>(D3)<br>	[soundfile]
その噂は広まってイかれた。	(そのうわさはひろまっていかれた。)<br>The rumor spread widely.<br>(Passive of イく)<br>(D3)<br>	[soundfile]
彼は友達をパーティーにイかせる。	(かれはともだちをぱーてぃーにいかせる。)<br>He made his friends go to the party.<br>(Causative of イく)<br>(D3)<br>	[soundfile]
旅立ちの時だ、新たな世界にイけ！	(たびだちのときだ、あらたなせかいにいけ！)<br>It's time to depart, go to a new world!<br>(Imperative of イく)<br>(D3)<br>	[soundfile]
もし天気が良ければ、散歩にイけばどうですか？	(もしてんきがよければ、さんぽにいけばどうですか？)<br>If the weather is good, how about going for a walk?<br>(Conditional of イく)<br>(D3)<br>	[soundfile]
この行為は法律で禁ずる。	(このこういはほうりつできんずる。)<br>This action is prohibited by law.<br>(Present Positive Plain of 禁ずる)<br>(E1)<br>	[soundfile]
自由な表現が禁ずられない社会を望む。	(じゆうなひょうげんがきんずられないしゃかいをのぞむ。)<br>I hope for a society where free expression is not prohibited.<br>(Present Negative Plain of 禁ずる)<br>(E1)<br>	[soundfile]
この場所では喫煙を禁ずります。	(このばしょではきつえんをきんずります。)<br>Smoking is prohibited in this area.<br>(Present Positive Polite of 禁ずる)<br>(E1)<br>	[soundfile]
ここでは写真撮影を禁ずりません。	(ここではしゃしんさつえいをきんずりません。)<br>Taking photos is not prohibited here.<br>(Present Negative Polite of 禁ずる)<br>(E1)<br>	[soundfile]
彼はルールを破った者を厳しく禁ずった。	(かれはるーるをやぶったものをきびしくきんずった。)<br>He strictly prohibited those who broke the rules.<br>(Past Positive Plain of 禁ずる)<br>(E1)<br>	[soundfile]
彼女は感情を制御することが禁ずられなかった。	(かのじょはかんじょうをせいぎょすることがきんずられなかった。)<br>She couldn't control her emotions.<br>(Past Negative Plain of 禁ずる)<br>(E1)<br>	[soundfile]
学校は携帯電話の使用を禁ずりました。	(がっこうはけいたいでんわのしようをきんずりました。)<br>The school prohibited the use of mobile phones.<br>(Past Positive Polite of 禁ずる)<br>(E1)<br>	[soundfile]
この地域では、昔から舞台公演が禁ずりませんでした。	(このちいきでは、むかしからぶたいこうえんがきんずりませんでした。)<br>In this area, stage performances have not been prohibited since ancient times.<br>(Past Negative Polite of 禁ずる)<br>(E1)<br>	[soundfile]
交通事故の増加を受けて、速度制限を禁ずっている。	(こうつうじこのぞうかをうけて、そくどせいげんをきんずっている。)<br>Speed limits have been imposed in response to the increase in traffic accidents.<br>(-te Form of 禁ずる)<br>(E1)<br>	[soundfile]
この問題には早急に対策を禁ずろう。	(このもんだいにはそうきゅうにたいさくをきんずろう。)<br>Let's take immediate measures to address this issue.<br>(Volitional of 禁ずる)<br>(E1)<br>	[soundfile]
その行動は社会的に禁ずれるべきだ。	(そのこうどうはしゃかいてきにきんずれるべきだ。)<br>That behavior should be socially prohibited.<br>(Potential of 禁ずる)<br>(E1)<br>	[soundfile]
この施設ではペットの持ち込みが禁ずられる。	(このしせつではぺっとのもちこんみがきんずられる。)<br>Bringing pets into this facility is prohibited.<br>(Passive of 禁ずる)<br>(E1)<br>	[soundfile]
上司は社員たちに私用のインターネットの使用を禁ずらせる。	(じょうしはしゃいんたちにしようのいんたーねっとのしようをきんずらせる。)<br>The boss prohibits employees from using the internet for personal reasons.<br>(Causative of 禁ずる)<br>(E1)<br>	[soundfile]
このエリアではゴミの投棄を禁ずれ！	(このえりあではごみのとうきをきんずれ！)<br>Prohibit littering in this area!<br>(Imperative of 禁ずる)<br>(E1)<br>	[soundfile]
健康に害があるものは、食べることを禁ずればいい。	(けんこうにがいがあるものは、たべることをきんずればいい。)<br>If something is harmful to health, it's better to prohibit eating it.<br>(Conditional of 禁ずる)<br>(E1)<br>	[soundfile]
彼は自分の能力を信ずる。	(かれはじぶんののうりょくをしんずる。)<br>He believes in his abilities.<br>(Present Positive Plain of 信ずる)<br>(E2)<br>	[soundfile]
私はその話を信じない。	(わたしはそのはなしをしんじない。)<br>I don't believe that story.<br>(Present Negative Plain of 信ずる)<br>(E2)<br>	[soundfile]
彼女は彼の約束を信じます。	(かのじょはかれのやくそくをしんじます。)<br>She believes in his promises.<br>(Present Positive Polite of 信ずる)<br>(E2)<br>	[soundfile]
私たちはその情報を信じません。	(わたしたちはそのじょうほうをしんじません。)<br>We don't believe that information.<br>(Present Negative Polite of 信ずる)<br>(E2)<br>	[soundfile]
私は彼の言葉を信じた。	(わたしはかれのことばをしんじた。)<br>I believed his words.<br>(Past Positive Plain of 信ずる)<br>(E2)<br>	[soundfile]
彼は彼女の言葉を信じなかった。	(かれはかのじょのことばをしんじなかった。)<br>He didn't believe her words.<br>(Past Negative Plain of 信ずる)<br>(E2)<br>	[soundfile]
彼らは奇跡を信じました。	(かれらはきせきをしんじました。)<br>They believed in miracles.<br>(Past Positive Polite of 信ずる)<br>(E2)<br>	[soundfile]
彼は彼の言葉を信じませんでした。	(かれはかれのことばをしんじませんでした。)<br>He didn't believe his words.<br>(Past Negative Polite of 信ずる)<br>(E2)<br>	[soundfile]
彼の言葉を信じて、行動しました。	(かれのことばをしんじて、こうどうしました。)<br>I acted believing his words.<br>(-te Form of 信ずる)<br>(E2)<br>	[soundfile]
私たちは未来を信じよう。	(わたしたちはみらいをしんじよう。)<br>Let's believe in the future.<br>(Volitional of 信ずる)<br>(E2)<br>	[soundfile]
その話は本当だと信じられる。	(そのはなしはほんとうだとしんじられる。)<br>That story can be believed to be true.<br>(Potential of 信ずる)<br>(E2)<br>	[soundfile]
この町では彼の言葉が信じられる。	(このまちではかれのことばがしんじられる。)<br>His words are believed in this town.<br>(Passive of 信ずる)<br>(E2)<br>	[soundfile]
両親は子供たちに夢を信じさせた。	(りょうしんはこどもたちにゆめをしんじさせた。)<br>The parents made their children believe in dreams.<br>(Causative of 信ずる)<br>(E2)<br>	[soundfile]
未来を信じろ！	(みらいをしんじろ！)<br>Believe in the future!<br>(Imperative of 信ずる)<br>(E2)<br>	[soundfile]
もし彼が言ったことが本当なら、彼を信じればいい。	(もしあのこがいったことがほんとうなら、かれをしんじればいい。)<br>If what he said is true, then we should believe him.<br>(Conditional of 信ずる)<br>(E2)<br>	[soundfile]
上司は即座に行動を命ずることがある。	(じょうしはそくざにこうどうをめいずることがある。)<br>The boss sometimes orders immediate action.<br>(Present Positive Plain of 命ずる)<br>(E3)<br>	[soundfile]
その問題について、特定の解決策を命ずらない。	(そのもんだいについて、とくていのかいけつさくをめいずらない。)<br>They don't mandate a specific solution to the problem.<br>(Present Negative Plain of 命ずる)<br>(E3)<br>	[soundfile]
社長は新しい方針を命ずりました。	(しゃちょうはあたらしいほうしんをめいずりました。)<br>The president ordered a new policy.<br>(Present Positive Polite of 命ずる)<br>(E3)<br>	[soundfile]
上司はそれについて何も命ずりませんでした。	(じょうしはそれについてなにもめいずりませんでした。)<br>The boss didn't order anything about that.<br>(Present Negative Polite of 命ずる)<br>(E3)<br>	[soundfile]
指揮官は撤退を命ずった。	(しきかんはてったいをめいずった。)<br>The commander ordered a retreat.<br>(Past Positive Plain of 命ずる)<br>(E3)<br>	[soundfile]
上司は何も命ずらなかった。	(じょうしはなにもめいずらなかった。)<br>The boss didn't order anything.<br>(Past Negative Plain of 命ずる)<br>(E3)<br>	[soundfile]
部長は緊急会議を命ずりました。	(ぶちょうはきんきゅうかいぎをめいずりました。)<br>The department head called for an emergency meeting.<br>(Past Positive Polite of 命ずる)<br>(E3)<br>	[soundfile]
社長はその問題についての新たな方針を命ずりませんでした。	(しゃちょうはそのもんだいについてのあらたなほうしんをめいずりませんでした。)<br>The president didn't mandate a new policy regarding that issue.<br>(Past Negative Polite of 命ずる)<br>(E3)<br>	[soundfile]
上司は改善を命ずっている。	(じょうしはかいぜんをめいずっている。)<br>The boss is ordering improvements.<br>(-te Form of 命ずる)<br>(E3)<br>	[soundfile]
新しい方針を命ずろう。	(あたらしいほうしんをめいずろう。)<br>Let's mandate a new policy.<br>(Volitional of 命ずる)<br>(E3)<br>	[soundfile]
指示が命ずれるまで待とう。	(しじがめいずれるまでまとう。)<br>Let's wait until instructions are given.<br>(Potential of 命ずる)<br>(E3)<br>	[soundfile]
指示が部下によって命ずられた。	(しじがぶかによってめいずられた。)<br>Instructions were given by the subordinate.<br>(Passive of 命ずる)<br>(E3)<br>	[soundfile]
上司は社員たちに新しい方針を命ずらせた。	(じょうしはしゃいんたちにあたらしいほうしんをめいずらせた。)<br>The boss had the employees implement a new policy.<br>(Causative of 命ずる)<br>(E3)<br>	[soundfile]
今すぐ対策を命ずれ！	(いますぐたいさくをめいずれ！)<br>Order measures now!<br>(Imperative of 命ずる)<br>(E3)<br>	[soundfile]
もし指示があれば、すぐに行動を命ずればいい。	(もししじがあれば、すぐにこうどうをめいずればいい。)<br>If there are instructions, we should order action immediately.<br>(Conditional of 命ずる)<br>(E3)<br>	[soundfile]
彼は毎朝プールで泳ぐ。	(かれはまいあさぷーるでおよぐ。)<br>He swims in the pool every morning.<br>(Present Positive Plain of 泳ぐ)<br>(F1)<br>	[soundfile]
私は泳がない。	(わたしはおよがない。)<br>I don't swim.<br>(Present Negative Plain of 泳ぐ)<br>(F1)<br>	[soundfile]
彼女は週末に海で泳ぎます。	(かのじょはしゅうまつにうみでおよぎます。)<br>She swims in the sea on weekends.<br>(Present Positive Polite of 泳ぐ)<br>(F1)<br>	[soundfile]
私たちは寒い日には海で泳ぎません。	(わたしたちはさむいひにはうみでおよぎません。)<br>We don't swim in the sea on cold days.<br>(Present Negative Polite of 泳ぐ)<br>(F1)<br>	[soundfile]
昨日、彼らは川で泳いだ。	(きのう、かれらはかわでおよいだ。)<br>They swam in the river yesterday.<br>(Past Positive Plain of 泳ぐ)<br>(F1)<br>	[soundfile]
子供の頃、彼は上手に泳がなかった。	(こどものころ、かれはじょうずにおよがなかった。)<br>He couldn't swim well when he was a child.<br>(Past Negative Plain of 泳ぐ)<br>(F1)<br>	[soundfile]
先月、プールで泳ぎました。	(せんげつ、ぷーるでおよぎました。)<br>I swam in the pool last month.<br>(Past Positive Polite of 泳ぐ)<br>(F1)<br>	[soundfile]
その日は波が荒かったので、海で泳ぎませんでした。	(そのひはなみがあらかったので、うみでおよぎませんでした。)<br>I didn't swim in the sea that day because the waves were rough.<br>(Past Negative Polite of 泳ぐ)<br>(F1)<br>	[soundfile]
湖で泳いで、気分がすっきりした。	(みずうみでおよいで、きぶんがすっきりした。)<br>I swam in the lake and felt refreshed.<br>(-te Form of 泳ぐ)<br>(F1)<br>	[soundfile]
明日は海で泳ごう。	(あしたはうみでおよごう。)<br>Let's swim in the sea tomorrow.<br>(Volitional of 泳ぐ)<br>(F1)<br>	[soundfile]
彼はとても速く泳げる。	(かれはとてもはやくおよげる。)<br>He can swim very fast.<br>(Potential of 泳ぐ)<br>(F1)<br>	[soundfile]
そのプールは毎日たくさんの人に泳がれる。	(そのぷーるはまいにちたくさんのひとにおよがれる。)<br>The pool is used by many people to swim every day.<br>(Passive of 泳ぐ)<br>(F1)<br>	[soundfile]
彼は子供たちに泳がせるのが好きだ。	(かれはこどもたちにおよがせるのがすきだ。)<br>He enjoys letting children swim.<br>(Causative of 泳ぐ)<br>(F1)<br>	[soundfile]
危険な水域には近づかずに泳げ！	(きけんなすいいきにはちかづかずにおよげ！)<br>Swim without approaching dangerous waters!<br>(Imperative of 泳ぐ)<br>(F1)<br>	[soundfile]
もし泳げば、川で遊びましょう。	(もしおよげば、かわであそびましょう。)<br>If you can swim, let's play in the river.<br>(Conditional of 泳ぐ)<br>(F1)<br>	[soundfile]
一つの成功は次ぐ成功を呼ぶ。	(ひとつのせいこうはつぎのせいこうをよぶ。)<br>One success leads to another.<br>(Present Positive Plain of 次ぐ)<br>(F2)<br>	[soundfile]
彼は今の状況に次がないと感じている。	(かれはいまのじょうきょうにつぎがないとかんじている。)<br>He feels there is no way forward in the current situation.<br>(Present Negative Plain of 次ぐ)<br>(F2)<br>	[soundfile]
この行動は問題を次ぎます。	(このこうどうはもんだいをつぎます。)<br>This action exacerbates the problem.<br>(Present Positive Polite of 次ぐ)<br>(F2)<br>	[soundfile]
この議論には進展が次ぎません。	(このぎろんにはしんてんがつぎません。)<br>There is no progress in this discussion.<br>(Present Negative Polite of 次ぐ)<br>(F2)<br>	[soundfile]
前のステップを次いで、次の段階に進んだ。	(まえのすてっぷをついで、つぎのだんかいにすすんだ。)<br>Following the previous step, we moved on to the next stage.<br>(Past Positive Plain of 次ぐ)<br>(F2)<br>	[soundfile]
彼はチャンスが次がなかった。	(かれはちゃんすがつぎがなかった。)<br>He had no further opportunities.<br>(Past Negative Plain of 次ぐ)<br>(F2)<br>	[soundfile]
プロジェクトの次ぎる段階に移行しました。	(ぷろじぇくとのつぎるだんかいにいこうしました。)<br>We transitioned to the next phase of the project.<br>(Past Positive Polite of 次ぐ)<br>(F2)<br>	[soundfile]
彼はその仕事に関心がなかったので、次ぎませんでした。	(かれはそのしごとにかんしんがなかったので、つぎませんでした。)<br>He wasn't interested in the job, so he didn't pursue it.<br>(Past Negative Polite of 次ぐ)<br>(F2)<br>	[soundfile]
一つの段落が終わると、次いで次の段落が始まる。	(ひとつのだんらくがおわると、ついでつぎのだんらくがはじまる。)<br>As one paragraph ends, the next paragraph begins.<br>(-te Form of 次ぐ)<br>(F2)<br>	[soundfile]
この計画を成功に導くためには、一致団結して次ごう。	(このけいかくをせいこうにみちびくためには、いっちだんけつしてつぎごう。)<br>To lead this plan to success, let's unite and move forward together.<br>(Volitional of 次ぐ)<br>(F2)<br>	[soundfile]
彼は次げる資質がある。	(かれはつげるしつしつがある。)<br>He has the ability to lead.<br>(Potential of 次ぐ)<br>(F2)<br>	[soundfile]
新しいイベントが計画され、次がれる。	(あたらしいいべんとがけいかくされ、つぎがれる。)<br>A new event is planned and will be followed.<br>(Passive of 次ぐ)<br>(F2)<br>	[soundfile]
彼は彼の部下にリーダーシップを発揮させ、次がせる。	(かれはかれのぶかにりーだーしっぷをはっきさせ、つぎがせる。)<br>He shows leadership to his subordinates and makes them follow.<br>(Causative of 次ぐ)<br>(F2)<br>	[soundfile]
この目標に向かって進み、前進を次げ！	(このもくひょうにむかってすすみ、ぜんしんをつげ！)<br>Move towards this goal and keep advancing!<br>(Imperative of 次ぐ)<br>(F2)<br>	[soundfile]
もし機会があれば、新しいアイデアを次げばいい。	(もしきかいがあれば、あたらしいあいであをつげばいい。)<br>If there is an opportunity, it's good to bring up new ideas.<br>(Conditional of 次ぐ)<br>(F2)<br>	[soundfile]
コーヒーをカップに注ぐ。	(こーひーをかっぷにそそぐ。)<br>Pour coffee into a cup.<br>(Present Positive Plain of 注ぐ)<br>(F3)<br>	[soundfile]
涙は彼の目から注がない。	(なみだはかれのめからそがない。)<br>Tears don't flow from his eyes.<br>(Present Negative Plain of 注ぐ)<br>(F3)<br>	[soundfile]
ジュースをグラスに注ぎます。	(じゅーすをぐらすにそそぎます。)<br>I pour juice into a glass.<br>(Present Positive Polite of 注ぐ)<br>(F3)<br>	[soundfile]
この容器から水が注ぎません。	(このようきからみずがそそぎません。)<br>Water doesn't pour from this container.<br>(Present Negative Polite of 注ぐ)<br>(F3)<br>	[soundfile]
ワインをグラスに注いだ。	(わいんをぐらすにそそいだ。)<br>Poured wine into a glass.<br>(Past Positive Plain of 注ぐ)<br>(F3)<br>	[soundfile]
彼の言葉に注意が注がなかった。	(かれのことばにちゅういがそがなかった。)<br>Attention wasn't paid to his words.<br>(Past Negative Plain of 注ぐ)<br>(F3)<br>	[soundfile]
ビールをジョッキに注ぎました。	(びーるをじょっきにそそぎました。)<br>Poured beer into a tankard.<br>(Past Positive Polite of 注ぐ)<br>(F3)<br>	[soundfile]
彼はコーヒーをカップに注ぎませんでした。	(かれはこーひーをかっぷにそそぎませんでした。)<br>He didn't pour coffee into the cup.<br>(Past Negative Polite of 注ぐ)<br>(F3)<br>	[soundfile]
醤油を料理に注いでください。	(しょうゆをりょうりにそいでください。)<br>Please pour soy sauce onto the dish.<br>(-te Form of 注ぐ)<br>(F3)<br>	[soundfile]
今夜は乾杯して、お酒をみんなに注ごう！	(こんやはかんぱいして、おさけをみんなにそごう！)<br>Let's cheers tonight and pour drinks for everyone!<br>(Volitional of 注ぐ)<br>(F3)<br>	[soundfile]
このポットからお湯が注げるようになっています。	(このぽっとからおゆがそげるようになっています。)<br>Hot water can be poured from this pot.<br>(Potential of 注ぐ)<br>(F3)<br>	[soundfile]
その花瓶には水が注がれている。	(そのかびんにはみずがそがれている。)<br>Water has been poured into the vase.<br>(Passive of 注ぐ)<br>(F3)<br>	[soundfile]
子供たちにお茶をカップに注がせた。	(こどもたちにおちゃをかっぷにそがせた。)<br>Made the children pour tea into cups.<br>(Causative of 注ぐ)<br>(F3)<br>	[soundfile]
ワインをグラスに注げ！	(わいんをぐらすにそげ！)<br>Pour wine into the glass!<br>(Imperative of 注ぐ)<br>(F3)<br>	[soundfile]
もしコーヒーをもう一度注げば、彼女は嬉しいだろう。	(もしこーひーをもういちどそげば、かのじょはうれしいだろう。)<br>If you pour coffee again, she will be happy.<br>(Conditional of 注ぐ)<br>(F3)<br>	[soundfile]
生きていれば、いつかは死ぬ。	(いきていれば、いつかはしぬ。)<br>If you live, someday you will die.<br>(Present Positive Plain of 死ぬ)<br>(G1)<br>	[soundfile]
彼は決して死なないだろう。	(かれはけっしてしなないだろう。)<br>He will never die.<br>(Present Negative Plain of 死ぬ)<br>(G1)<br>	[soundfile]
私の祖母は平和に死にます。	(わたしのそぼはへいわにしにます。)<br>My grandmother will peacefully pass away.<br>(Present Positive Polite of 死ぬ)<br>(G1)<br>	[soundfile]
その病気は治療すれば死にません。	(そのびょうきはちりょうすればしにません。)<br>The disease won't be fatal if treated.<br>(Present Negative Polite of 死ぬ)<br>(G1)<br>	[soundfile]
彼は昨日死んだ。	(かれはきのうしんだ。)<br>He died yesterday.<br>(Past Positive Plain of 死ぬ)<br>(G1)<br>	[soundfile]
その事故で彼は死ななかった。	(そのじこでかれはしななかった。)<br>He didn't die in the accident.<br>(Past Negative Plain of 死ぬ)<br>(G1)<br>	[soundfile]
その俳優は映画の中で死にました。	(そのはいゆうはえいがのなかでしにました。)<br>The actor died in the movie.<br>(Past Positive Polite of 死ぬ)<br>(G1)<br>	[soundfile]
その手術は成功して、患者は死にませんでした。	(そのしゅじゅつはせいこうして、かんじゃはしにませんでした。)<br>The surgery was successful, and the patient didn't die.<br>(Past Negative Polite of 死ぬ)<br>(G1)<br>	[soundfile]
勇敢な戦士は戦場で死んでいった。	(ゆうかんなせんしはせんじょうでしんでいった。)<br>The brave warrior died on the battlefield.<br>(-te Form of 死ぬ)<br>(G1)<br>	[soundfile]
もうこの苦しみから解放されるために死のう。	(もうこのくしみからかいほうされるためにしのう。)<br>Let's die to be freed from this suffering.<br>(Volitional of 死ぬ)<br>(G1)<br>	[soundfile]
彼は病気が重くてもまだ死ねると思います。	(かれはびょうきがおもくてもまだしねるとおもいます。)<br>I think he can still die even if the illness is severe.<br>(Potential of 死ぬ)<br>(G1)<br>	[soundfile]
猫が道路で車に轢かれて死なれた。	(ねこがどうろでくるまにひかれてしなれた。)<br>The cat was hit by a car on the road and died.<br>(Passive of 死ぬ)<br>(G1)<br>	[soundfile]
彼の行動が多くの人々を死なせた。	(かれのこうどうがおおくのひとびとをしなせた。)<br>His actions caused many people to die.<br>(Causative of 死ぬ)<br>(G1)<br>	[soundfile]
危ない！ すぐに逃げろ！死ねる！	(あぶない！すぐににげろ！しねる！)<br>Dangerous! Run away quickly! You could die!<br>(Imperative of 死ぬ)<br>(G1)<br>	[soundfile]
もし彼がそれを食べれば、死ねばいい。	(もしこれをたべれば、しねばいい。)<br>If he eats it, it's okay if he dies.<br>(Conditional of 死ぬ)<br>(G1)<br>	[soundfile]
彼はとうとうその仕事を去ぬことになった。	(かれはとうとうそのしごとをさることになった。)<br>He finally decided to leave that job.<br>(Present Positive Plain of 去ぬ)<br>(G2)<br>	[soundfile]
彼はまだその街を去らないでいる。	(かれはまだそのまちをさらないでいる。)<br>He is still staying in that town.<br>(Present Negative Plain of 去ぬ)<br>(G2)<br>	[soundfile]
明日、彼は新しい街に去ります。	(あした、かれはあたらしいまちにさります。)<br>He will leave for a new town tomorrow.<br>(Present Positive Polite of 去ぬ)<br>(G2)<br>	[soundfile]
なぜ彼はその会社を去りませんか。	(なぜかれはそのかいしゃをさりませんか。)<br>Why doesn't he leave that company?<br>(Present Negative Polite of 去ぬ)<br>(G2)<br>	[soundfile]
彼は家族を置いて故郷を去った。	(かれはかぞくをおいてふるさとをさった。)<br>He left his family and hometown.<br>(Past Positive Plain of 去ぬ)<br>(G2)<br>	[soundfile]
彼は招待されたが、結局はそのパーティーには去らなかった。	(かれはしょうたいされたが、けっきょくはそのぱーてぃーにはさらなかった。)<br>He was invited, but in the end, he didn't go to the party.<br>(Past Negative Plain of 去ぬ)<br>(G2)<br>	[soundfile]
彼は突然、その場を去りました。	(かれはとつぜん、そのばをさりました。)<br>He suddenly left the scene.<br>(Past Positive Polite of 去ぬ)<br>(G2)<br>	[soundfile]
私はその会議には招待されましたが、結局は参加しませんでした。	(わたしはそのかいぎにはしょうたいされましたが、けっきょくはさんかしませんでした。)<br>I was invited to the meeting, but in the end, I didn't attend.<br>(Past Negative Polite of 去ぬ)<br>(G2)<br>	[soundfile]
彼は怒ってその場を去ってしまった。	(かれはおこってそのばをさってしまった。)<br>He got angry and left the scene.<br>(-te Form of 去ぬ)<br>(G2)<br>	[soundfile]
この街から去ろうと決めた。	(このまちからさろうときめた。)<br>I decided to leave this town.<br>(Volitional of 去ぬ)<br>(G2)<br>	[soundfile]
あの人はいつでも新しい仕事に行けれる。	(あのひとはいつでもあたらしいしごとにいけれる。)<br>That person can always find a new job.<br>(Potential of 去ぬ)<br>(G2)<br>	[soundfile]
彼は退職を迫られ、会社を去られた。	(かれはたいしょくをせまられ、かいしゃをさられた。)<br>He was forced to retire and left the company.<br>(Passive of 去ぬ)<br>(G2)<br>	[soundfile]
彼女の行動は彼をその場を去らせた。	(かのじょのこうどうはかれをそのばをさらせた。)<br>Her actions made him leave the scene.<br>(Causative of 去ぬ)<br>(G2)<br>	[soundfile]
この場を去れ！	(このばをされ！)<br>Leave this place!<br>(Imperative of 去ぬ)<br>(G2)<br>	[soundfile]
もし彼が納得すれば、彼女はすぐにでもこの会社を去ればいい。	(もしこれをたべれば、しねばいい。)<br>If he agrees, she should leave this company immediately.<br>(Conditional of 去ぬ)<br>(G2)<br>	[soundfile]
我々は希望に往ぬ。	(われわれはきぼうにいぬ。)<br>We proceed with hope.<br>(Present Positive Plain of 往ぬ)<br>(G3)<br>	[soundfile]
彼は決してその道を往かぬだろう。	(かれはけっしてそのみちをいかぬだろう。)<br>He will never go down that path.<br>(Present Negative Plain of 往ぬ)<br>(G3)<br>	[soundfile]
多くの人々が新しい未来に向かって往きます。	(おおくのひとびとがあたらしいみらいにむかっていきます。)<br>Many people are moving towards a new future.<br>(Present Positive Polite of 往ぬ)<br>(G3)<br>	[soundfile]
その問題はすぐに解決されないので、往きません。	(そのもんだいはすぐにかいけつされないので、いきません。)<br>The problem won't be resolved soon, so we won't proceed.<br>(Present Negative Polite of 往ぬ)<br>(G3)<br>	[soundfile]
彼は故郷に往った。	(かれはこきょうにいった。)<br>He went back to his hometown.<br>(Past Positive Plain of 往ぬ)<br>(G3)<br>	[soundfile]
そのイベントには彼は往かなかった。	(そのいべんとにはかれはいかなかった。)<br>He didn't go to that event.<br>(Past Negative Plain of 往ぬ)<br>(G3)<br>	[soundfile]
彼は昨日、東京に往きました。	(かれはきのう、とうきょうにいきました。)<br>He went to Tokyo yesterday.<br>(Past Positive Polite of 往ぬ)<br>(G3)<br>	[soundfile]
彼はその提案に賛成しなかったので、会議に往きませんでした。	(かれはそのていあんにさんせいしなかったので、かいぎにいきませんでした。)<br>He didn't agree with the proposal, so he didn't attend the meeting.<br>(Past Negative Polite of 往ぬ)<br>(G3)<br>	[soundfile]
パーティーに招待され、喜んで往いてきました。	(ぱーてぃーにしょうたいされ、よろこんでいってきました。)<br>I was invited to the party and happily went.<br>(-te Form of 往ぬ)<br>(G3)<br>	[soundfile]
この旅は未知の世界に向かって往こう。	(このたびはみちのせかいにむかっていこう。)<br>Let's head towards the unknown world on this journey.<br>(Volitional of 往ぬ)<br>(G3)<br>	[soundfile]
彼はその任務を果たすだけの力があるかどうかわからないが、往けると思います。	(かれはそのにんむをはたすだけのちからがあるかどうかわからないが、いけるとおもいます。)<br>I'm not sure if he has the strength to fulfill the mission, but I think he can go.<br>(Potential of 往ぬ)<br>(G3)<br>	[soundfile]
葬儀に多くの人々が故人を送るために往かれた。	(そうぎにおおくのひとびとがこじんをおくるためにいかれた。)<br>Many people attended the funeral to send off the deceased.<br>(Passive of 往ぬ)<br>(G3)<br>	[soundfile]
その計画は多くの人々に新しい未来に向かって往かせる。	(そのけいかくはおおくのひとびとにあたらしいみらいにむかっていかせる。)<br>The plan will lead many people towards a new future.<br>(Causative of 往ぬ)<br>(G3)<br>	[soundfile]
恐れずに前に進んで往け！	(おそれずにまえにすすんでいけ！)<br>Go forward without fear!<br>(Imperative of 往ぬ)<br>(G3)<br>	[soundfile]
もし彼女がその町に行けば、彼は彼女を案内するだろう。	(もしこじょがそのまちにいけば、かれはかのじょをあんないするだろう。)<br>If she goes to that town, he will guide her.<br>(Conditional of 往ぬ)<br>(G3)<br>	[soundfile]
友達が今晩訪れる。	(ともだちがこんばんおとずれる。)<br>A friend is coming over tonight.<br>(Present Positive Plain of 来る)<br>(H1)<br>	[soundfile]
彼女はいつも時間通りに来ない。	(かのじょはいつもじかんどおりにこない。)<br>She never comes on time.<br>(Present Negative Plain of 来る)<br>(H1)<br>	[soundfile]
先週、彼は私の家に来ました。	(せんしゅう、かれはわたしのいえにきました。)<br>He came to my house last week.<br>(Present Positive Polite of 来る)<br>(H1)<br>	[soundfile]
彼は毎日遅れて学校に来ません。	(かれはまいにちおくれてがっこうにきません。)<br>He doesn't come to school late every day.<br>(Present Negative Polite of 来る)<br>(H1)<br>	[soundfile]
彼は昨日、遅れて来た。	(かれはきのう、おくれてきた。)<br>He came late yesterday.<br>(Past Positive Plain of 来る)<br>(H1)<br>	[soundfile]
彼女は約束の時間に来なかった。	(かのじょはやくそくのじかんにこなかった。)<br>She didn't come at the agreed time.<br>(Past Negative Plain of 来る)<br>(H1)<br>	[soundfile]
先週末、彼はパーティーに来ました。	(せんしゅうまつ、かれはぱーてぃーにきました。)<br>He came to the party last weekend.<br>(Past Positive Polite of 来る)<br>(H1)<br>	[soundfile]
彼はそのプロジェクトに関心を示さず、会議に来ませんでした。	(かれはそのぷろじぇくとにかんしんをしめさず、かいぎにきませんでした。)<br>He didn't show interest in the project and didn't come to the meeting.<br>(Past Negative Polite of 来る)<br>(H1)<br>	[soundfile]
彼は私の家に遊びに来ています。	(かれはわたしのいえにあそびにきています。)<br>He is coming over to my house to hang out.<br>(-te Form of 来る)<br>(H1)<br>	[soundfile]
明日、公園でピクニックしに来よう！	(あした、こうえんでぴくにっくしにこよう！)<br>Let's come to the park for a picnic tomorrow!<br>(Volitional of 来る)<br>(H1)<br>	[soundfile]
彼は今日は忙しいので、来られないかもしれません。	(かれはきょうはいそがしいので、こられないかもしれません。)<br>He might not be able to come today because he's busy.<br>(Potential of 来る)<br>(H1)<br>	[soundfile]
このイベントには多くの人が来られるだろう。	(このいべんとにはおおくのひとがこられるだろう。)<br>Many people will come to this event.<br>(Passive of 来る)<br>(H1)<br>	[soundfile]
私は友達をパーティーに来させた。	(わたしはともだちをぱーてぃーにきさせた。)<br>I made my friend come to the party.<br>(Causative of 来る)<br>(H1)<br>	[soundfile]
早く来い！	(はやくこい！)<br>Come quickly!<br>(Imperative of 来る)<br>(H1)<br>	[soundfile]
もし彼が時間があれば、明日の会議に来ればいい。	(もしこじょがじかんがあれば、あしたのかいぎにきればいい。)<br>If he has time, he should come to tomorrow's meeting.<br>(Conditional of 来る)<br>(H1)<br>	[soundfile]
彼は犬を公園に連れて来る。	(かれはいぬをこうえんにつれてくる。)<br>He brings his dog to the park.<br>(Present Positive Plain of 連れて来る)<br>(H2)<br>	[soundfile]
なぜ彼は友達をパーティーに連れて来ないのか。	(なぜかれはともだちをぱーてぃーにつれてこないのか。)<br>Why doesn't he bring his friend to the party?<br>(Present Negative Plain of 連れて来る)<br>(H2)<br>	[soundfile]
先生がクラスに新しい生徒を連れて来ます。	(せんせいがくらすにあたらしいせいとをつれてきます。)<br>The teacher brings a new student to the class.<br>(Present Positive Polite of 連れて来る)<br>(H2)<br>	[soundfile]
彼は今日、子供たちを学校に連れて来ませんでした。	(かれはきょう、こどもたちをがっこうにつれてきませんでした。)<br>He didn't bring the kids to school today.<br>(Present Negative Polite of 連れて来る)<br>(H2)<br>	[soundfile]
彼は妹を映画館に連れて来た。	(かれはいもうとをえいがかんにつれてきた。)<br>He brought his sister to the movie theater.<br>(Past Positive Plain of 連れて来る)<br>(H2)<br>	[soundfile]
彼女は約束の場所に私を連れて来なかった。	(かのじょはやくそくのばしょにわたしをつれてこなかった。)<br>She didn't bring me to the agreed place.<br>(Past Negative Plain of 連れて来る)<br>(H2)<br>	[soundfile]
彼は先週、私たちを美しい湖に連れて来ました。	(かれはせんしゅう、わたしたちをうつくしいみずうみにつれてきました。)<br>He brought us to a beautiful lake last week.<br>(Past Positive Polite of 連れて来る)<br>(H2)<br>	[soundfile]
彼らは約束の時間に遅れて連れて来ませんでした。	(かれらはやくそくのじかんにおくれてつれてきませんでした。)<br>They didn't bring him over at the agreed time.<br>(Past Negative Polite of 連れて来る)<br>(H2)<br>	[soundfile]
彼女は犬を公園に連れて来ています。	(かのじょはいぬをこうえんにつれてきています。)<br>She is bringing her dog to the park.<br>(-te Form of 連れて来る)<br>(H2)<br>	[soundfile]
今度の旅行で彼らを美しい場所に連れて来よう。	(こんどのりょこうでかれらをうつくしいばしょにつれてこよう。)<br>Let's bring them to a beautiful place on this trip.<br>(Volitional of 連れて来る)<br>(H2)<br>	[soundfile]
この犬は子供たちに連れて来られる。	(このいぬはこどもたちにつれてこられる。)<br>This dog can be brought by the children.<br>(Potential of 連れて来る)<br>(H2)<br>	[soundfile]
明日、私たちは友達に新しいレストランに連れて来られる。	(あした、わたしたちはともだちにあたらしいれすとらんにつれてこられる。)<br>Tomorrow, we will be brought to a new restaurant by our friend.<br>(Passive of 連れて来る)<br>(H2)<br>	[soundfile]
今夜、私は彼をパーティーに連れて来させるつもりです。	(こんや、わたしはかれをぱーてぃーにつれてこさせるつもりです。)<br>Tonight, I intend to bring him to the party.<br>(Causative of 連れて来る)<br>(H2)<br>	[soundfile]
犬を散歩に連れて来い。	(いぬをさんぽにつれてこい。)<br>Bring the dog for a walk.<br>(Imperative of 連れて来る)<br>(H2)<br>	[soundfile]
もし彼が遅れれば、彼女は犬を連れて来ればいい。	(もしこれがおくれれば、かのじょはいぬをつれてこればいい。)<br>If he is late, she should bring the dog.<br>(Conditional of 連れて来る)<br>(H2)<br>	[soundfile]
公園には多くの木が有る。	(こうえんにはおおくのきがある。)<br>There are many trees in the park.<br>(Present Positive Plain of 有る)<br>(I1)<br>	[soundfile]
この地域には地下鉄が有らない。	(このちいきにはちかてつがあらない。)<br>There is no subway in this area.<br>(Present Negative Plain of 有る)<br>(I1)<br>	[soundfile]
この街には新しいレストランが有りますか。	(このまちにはあたらしいれすとらんがありますか。)<br>Is there a new restaurant in this town?<br>(Present Positive Polite of 有る)<br>(I1)<br>	[soundfile]
彼女の家にはペットが有りません。	(かのじょのいえにはぺっとがありません。)<br>There are no pets in her house.<br>(Present Negative Polite of 有る)<br>(I1)<br>	[soundfile]
昨日、ここには人が多かった。	(きのう、ここにはひとがおおかった。)<br>There were many people here yesterday.<br>(Past Positive Plain of 有る)<br>(I1)<br>	[soundfile]
その町には電車が有らなかった。	(そのまちにはでんしゃがあらなかった。)<br>There was no train in that town.<br>(Past Negative Plain of 有る)<br>(I1)<br>	[soundfile]
先週、私の友達がここにいた時、雨が有りました。	(せんしゅう、わたしのともだちがここにいたとき、あめがありました。)<br>It was raining when my friend was here last week.<br>(Past Positive Polite of 有る)<br>(I1)<br>	[soundfile]
その会議には多くの人が期待されましたが、実際には少ない人が参加有りませんでした。	(そのかいぎにはおおくのひとがきたいされましたが、じっさいにはすくないひとがさんかありませんでした。)<br>Many people were expected at the meeting, but actually few people attended.<br>(Past Negative Polite of 有る)<br>(I1)<br>	[soundfile]
彼の家にはプールが有って、庭が広いです。	(かれのいえにはぷーるがあって、にわがひろいです。)<br>His house has a pool, and the garden is spacious.<br>(-te Form of 有る)<br>(I1)<br>	[soundfile]
新しいプロジェクトが成功するといいですね、多くの仕事が有ろう。	(あたらしいぷろじぇくとがせいこうするといいですね、おおくのしごとがあろう。)<br>I hope the new project succeeds, and there will be plenty of work.<br>(Volitional of 有る)<br>(I1)<br>	[soundfile]
彼はその任務を果たすだけの能力があれば、成功するだろう。	(かれはそのにんむをはたすだけののうりょくがあれば、せいこうするだろう。)<br>If he has the ability to fulfill the mission, he will succeed.<br>(Potential of 有る)<br>(I1)<br>	[soundfile]
その地域には多くの問題が有られている。	(そのちいきにはおおくのもんだいがあります。)<br>There are many problems in that area.<br>(Passive of 有る)<br>(I1)<br>	[soundfile]
彼の努力が新しいアイデアを生み出し、多くの機会を有らせる。	(かれのどりょくがあたらしいあいであをうみだし、おおくのきかいをあります。)<br>His efforts generate new ideas and create many opportunities.<br>(Causative of 有る)<br>(I1)<br>	[soundfile]
このプロジェクトの成功には、皆の協力が有れ！	(このぷろじぇくとのせいこうには、みんなのきょうりょくがあり！)<br>We need everyone's cooperation for the success of this project!<br>(Imperative of 有る)<br>(I1)<br>	[soundfile]
もし彼がその計画に参加するなら、彼の才能が有れば大きな貢献をするだろう。	(もしこじょがそのけいかくにさんかするなら、かれのさいのうがあればおおきなこうけんをするだろう。)<br>If he participates in the plan, his talent will make a significant contribution if he has it.<br>(Conditional of 有る)<br>(I1)<br>	[soundfile]
彼女は毎日日記を書く。	(かのじょはまいにちにっきをかく。)<br>She writes in her diary every day.<br>(Present Positive Plain of 書く)<br>(J1)<br>	[soundfile]
彼は手紙を書かない。	(かれはてがみをかかない。)<br>He doesn't write letters.<br>(Present Negative Plain of 書く)<br>(J1)<br>	[soundfile]
先生が宿題の課題を書きます。	(せんせいがしゅくだいのかだいをかきます。)<br>The teacher writes homework assignments.<br>(Present Positive Polite of 書く)<br>(J1)<br>	[soundfile]
私は彼に手紙を書きません。	(わたしはかれにてがみをかきません。)<br>I don't write letters to him.<br>(Present Negative Polite of 書く)<br>(J1)<br>	[soundfile]
昨日、詩を書いた。	(きのう、しをかいた。)<br>I wrote a poem yesterday.<br>(Past Positive Plain of 書く)<br>(J1)<br>	[soundfile]
彼女はレポートを書かなかった。	(かのじょはれぽーとをかかなかった。)<br>She didn't write the report.<br>(Past Negative Plain of 書く)<br>(J1)<br>	[soundfile]
先週、私は手紙を書きました。	(せんしゅう、わたしはてがみをかきました。)<br>I wrote a letter last week.<br>(Past Positive Polite of 書く)<br>(J1)<br>	[soundfile]
彼は誕生日カードを書きませんでした。	(かれはたんじょうびかーどをかきませんでした。)<br>He didn't write a birthday card.<br>(Past Negative Polite of 書く)<br>(J1)<br>	[soundfile]
彼は本を読んで、レポートを書いています。	(かれはほんをよんで、れぽーとをかいています。)<br>He is reading a book and writing a report.<br>(-te Form of 書く)<br>(J1)<br>	[soundfile]
今日はたくさん宿題を片付けて、新しい物語を書こう。	(きょうはたくさんしゅくだいをかたづけて、あたらしいものがたりをかこう。)<br>Let's finish a lot of homework today and write a new story.<br>(Volitional of 書く)<br>(J1)<br>	[soundfile]
彼女は速く手紙を書ける。	(かのじょははやくてがみをかける。)<br>She can write letters quickly.<br>(Potential of 書く)<br>(J1)<br>	[soundfile]
その小説は著者によって書かれました。	(そのしょうせつはちょしゃによってかかれました。)<br>The novel was written by the author.<br>(Passive of 書く)<br>(J1)<br>	[soundfile]
先生は生徒にレポートを書かせます。	(せんせいはせいとにれぽーとをかかせます。)<br>The teacher makes the students write reports.<br>(Causative of 書く)<br>(J1)<br>	[soundfile]
宿題を早く書け！	(しゅくだいをはやくかけ！)<br>Write your homework quickly!<br>(Imperative of 書く)<br>(J1)<br>	[soundfile]
もし彼が手紙を書けば、私は返信します。	(もしこじょがてがみをかけば、わたしはへんしんします。)<br>If he writes a letter, I will reply.<br>(Conditional of 書く)<br>(J1)<br>	[soundfile]
彼はよく音楽を聞く。	(かれはよくおんがくをきく。)<br>He often listens to music.<br>(Present Positive Plain of 聞く)<br>(J2)<br>	[soundfile]
彼は先生の話を聞かない。	(かれはせんせいのはなしをきかない。)<br>He doesn't listen to the teacher's story.<br>(Present Negative Plain of 聞く)<br>(J2)<br>	[soundfile]
彼女は毎晩ラジオを聞きます。	(かのじょはまいばんらじおをききます。)<br>She listens to the radio every night.<br>(Present Positive Polite of 聞く)<br>(J2)<br>	[soundfile]
私はそのニュースを聞きませんでした。	(わたしはそのにゅーすをききませんでした。)<br>I didn't listen to the news.<br>(Present Negative Polite of 聞く)<br>(J2)<br>	[soundfile]
彼は昨日、その話を聞いた。	(かれはきのう、そのはなしをきいた。)<br>He heard the story yesterday.<br>(Past Positive Plain of 聞く)<br>(J2)<br>	[soundfile]
私は彼の話を聞かなかった。	(わたしはかれのはなしをきかなかった。)<br>I didn't hear his story.<br>(Past Negative Plain of 聞く)<br>(J2)<br>	[soundfile]
先週、会議で興味深い話を聞きました。	(せんしゅう、かいぎできょうみぶかいはなしをききました。)<br>I heard an interesting story at the meeting last week.<br>(Past Positive Polite of 聞く)<br>(J2)<br>	[soundfile]
彼は先生の指示を聞きませんでした。	(かれはせんせいのしじをききませんでした。)<br>He didn't listen to the teacher's instructions.<br>(Past Negative Polite of 聞く)<br>(J2)<br>	[soundfile]
彼は私の相談を聞いてくれました。	(かれはわたしのそうだんをきいてくれました。)<br>He listened to my consultation.<br>(-te Form of 聞く)<br>(J2)<br>	[soundfile]
もっと意見を聞こう！	(もっといけんをきこう！)<br>Let's listen to more opinions!<br>(Volitional of 聞く)<br>(J2)<br>	[soundfile]
彼は遠くの音も聞ける。	(かれはとおくのおともきける。)<br>He can hear even distant sounds.<br>(Potential of 聞く)<br>(J2)<br>	[soundfile]
その質問は多くの人によって聞かれました。	(そのしつもんはおおくのひとによってきかれました。)<br>The question was asked by many people.<br>(Passive of 聞く)<br>(J2)<br>	[soundfile]
私は彼に音楽を聞かせました。	(わたしはかれにおんがくをきかせました。)<br>I made him listen to the music.<br>(Causative of 聞く)<br>(J2)<br>	[soundfile]
彼の忠告を聞け！	(かれのちゅうこくをきけ！)<br>Listen to his advice!<br>(Imperative of 聞く)<br>(J2)<br>	[soundfile]
もし彼が言うことを聞けば、うまくいくだろう。	(もしこじょがいうことをきけば、うまくいくだろう。)<br>If you listen to what he says, it will go well.<br>(Conditional of 聞く)<br>(J2)<br>	[soundfile]
毎晩、彼は机に本を置く。	(まいばん、かれはつくえにほんをおく。)<br>Every night, he puts books on the desk.<br>(Present Positive Plain of 置く)<br>(J3)<br>	[soundfile]
私は決して財布を机の上に置かない。	(わたしはけっしてさいふをつくえのうえにおかない。)<br>I never put my wallet on the desk.<br>(Present Negative Plain of 置く)<br>(J3)<br>	[soundfile]
先生は学生の机の上に課題を置きます。	(せんせいはがくせいのつくえのうえにかだいをおきます。)<br>The teacher puts assignments on the students' desks.<br>(Present Positive Polite of 置く)<br>(J3)<br>	[soundfile]
彼はいつも靴を玄関に置きません。	(かれはいつもくつをげんかんにおきません。)<br>He never puts his shoes in the hallway.<br>(Present Negative Polite of 置く)<br>(J3)<br>	[soundfile]
彼は昨日、花瓶を机の上に置いた。	(かれはきのう、かびんをつくえのうえにおいた。)<br>He put a vase on the desk yesterday.<br>(Past Positive Plain of 置く)<br>(J3)<br>	[soundfile]
彼女は帽子をその場所に置かなかった。	(かのじょはぼうしをそのばしょにおかなかった。)<br>She didn't put her hat in that place.<br>(Past Negative Plain of 置く)<br>(J3)<br>	[soundfile]
私は昨日、彼の荷物を机の下に置きました。	(わたしはきのう、かれのにもつをつくえのしたにおきました。)<br>I put his luggage under the desk yesterday.<br>(Past Positive Polite of 置く)<br>(J3)<br>	[soundfile]
彼は忘れ物を玄関に置きませんでした。	(かれはわすれものをげんかんにおきませんでした。)<br>He didn't put the forgotten item in the hallway.<br>(Past Negative Polite of 置く)<br>(J3)<br>	[soundfile]
彼女はカギをテーブルの上に置いて出かけました。	(かのじょはかぎをてーぶるのうえにおいてでかけました。)<br>She put the keys on the table and left.<br>(-te Form of 置く)<br>(J3)<br>	[soundfile]
家具を新しい配置に置こう！	(かぐをあたらしいはいちにおこう！)<br>Let's put the furniture in a new arrangement!<br>(Volitional of 置く)<br>(J3)<br>	[soundfile]
その箱は大きすぎて、机の上に置けません。	(そのはこはおおきすぎて、つくえのうえにおけません。)<br>The box is too big to put on the desk.<br>(Potential of 置く)<br>(J3)<br>	[soundfile]
その問題は重要な場所に置かれました。	(そのもんだいはじゅうようなばしょにおかれました。)<br>The problem was placed in an important position.<br>(Passive of 置く)<br>(J3)<br>	[soundfile]
私は彼に机の上にコーヒーカップを置かせた。	(わたしはかれにつくえのうえにこーひーかっぷをおかせた。)<br>I made him put the coffee cup on the desk.<br>(Causative of 置く)<br>(J3)<br>	[soundfile]
その荷物をここに置け！	(そのにもつをここにおけ！)<br>Put the luggage here!<br>(Imperative of 置く)<br>(J3)<br>	[soundfile]
もし彼が椅子に荷物を置けば、場所が空くだろう。	(もしこじょがいすににもつをおけば、ばしょがあくだろう。)<br>If he puts the luggage on the chair, space will become available.<br>(Conditional of 置く)<br>(J3)<br>	[soundfile]
彼は新しい人に友好的に接する。	(かれはあたらしいひとにゆうこうてきにせっする。)<br>He interacts with new people in a friendly manner.<br>(Present Positive Plain of 接する)<br>(K1)<br>	[soundfile]
その問題には直接接しない方がいいかもしれません。	(そのもんだいにはちょくせつせっしないほうがいいかもしれません。)<br>It might be better not to directly deal with that issue.<br>(Present Negative Plain of 接する)<br>(K1)<br>	[soundfile]
私たちは顧客と親しく接します。	(わたしたちはこきゃくとしたしくせっします。)<br>We interact closely with customers.<br>(Present Positive Polite of 接する)<br>(K1)<br>	[soundfile]
社長は一般の従業員とはあまり接しません。	(しゃちょうはいっぱんのじゅうぎょういんとはあまりせっしません。)<br>The president doesn't interact much with ordinary employees.<br>(Present Negative Polite of 接する)<br>(K1)<br>	[soundfile]
昨日、彼は重要なクライアントと接した。	(きのう、かれはじゅうようなくらいあんとせっした。)<br>He interacted with an important client yesterday.<br>(Past Positive Plain of 接する)<br>(K1)<br>	[soundfile]
彼女はその問題に直接接しなかった。	(かのじょはそのもんだいにちょくせつせっしなかった。)<br>She didn't directly deal with that issue.<br>(Past Negative Plain of 接する)<br>(K1)<br>	[soundfile]
先週、私たちは外国のビジネスパートナーと接しました。	(せんしゅう、わたしたちはがいこくのびじねすぱーとなーとせっしました。)<br>Last week, we interacted with foreign business partners.<br>(Past Positive Polite of 接する)<br>(K1)<br>	[soundfile]
社員はその案件について報告書を書きましたが、役員はそれに接しませんでした。	(しゃいんはそのあんけんについてほうこくしょをかきましたが、やくいんはそれにせっしませんでした。)<br>The employee wrote a report about the matter, but the executives did not deal with it.<br>(Past Negative Polite of 接する)<br>(K1)<br>	[soundfile]
彼は礼儀正しく相手に接しています。	(かれはれいぎただしくあいてにせっしています。)<br>He is politely interacting with the other party.<br>(-te Form of 接する)<br>(K1)<br>	[soundfile]
新しいチームメンバーと一緒に仕事を楽しみながら接しよう！	(あたらしいちーむめんばーといっしょにしごとをたのしみながらせっしよう！)<br>Let's interact with the new team members while enjoying our work!<br>(Volitional of 接する)<br>(K1)<br>	[soundfile]
彼は状況に応じて上手に人々と接できる。	(かれはじょうきょうにおうじてうまくひとびととせっできる。)<br>He can interact well with people depending on the situation.<br>(Potential of 接する)<br>(K1)<br>	[soundfile]
その提案は関係者から良く接された。	(そのていあんはかんけいしゃからよくせっされた。)<br>The proposal was well received by the stakeholders.<br>(Passive of 接する)<br>(K1)<br>	[soundfile]
私は彼にクライアントと直接接させます。	(わたしはかれにくらいあんとちょくせつせっさせます。)<br>I will have him directly deal with the clients.<br>(Causative of 接する)<br>(K1)<br>	[soundfile]
すぐに問題に接せよ！	(すぐにもんだいにせっせよ！)<br>Deal with the problem immediately!<br>(Imperative of 接する)<br>(K1)<br>	[soundfile]
もし彼女が彼を信頼すれば、彼はもっと協力的に接すればいい。	(もしこじょがかれをしんらいすれば、かれはもっときょうりょくてきにせっすればいい。)<br>If she trusts him, he should interact more cooperatively.<br>(Conditional of 接する)<br>(K1)<br>	[soundfile]
そのグループは声明を発する。	(そのぐるーぷはせいめいをはっする。)<br>The group issues a statement.<br>(Present Positive Plain of 発する)<br>(K2)<br>	[soundfile]
彼は意見を発しないことが多い。	(かれはいけんをはっしないことがおおい。)<br>He often doesn't express his opinions.<br>(Present Negative Plain of 発する)<br>(K2)<br>	[soundfile]
会議で新しいアイデアを発します。	(かいぎであたらしいあいであをはっします。)<br>We present new ideas at the meeting.<br>(Present Positive Polite of 発する)<br>(K2)<br>	[soundfile]
彼女は公の場で感情を発しません。	(かのじょはおおやけのばでかんじょうをはっしません。)<br>She doesn't show emotions in public.<br>(Present Negative Polite of 発する)<br>(K2)<br>	[soundfile]
その会議で意見を発した。	(そのかいぎでいけんをはっした。)<br>He expressed his opinion at the meeting.<br>(Past Positive Plain of 発する)<br>(K2)<br>	[soundfile]
彼はその件について何も発さなかった。	(かれはそのけんについてなにもはっさなかった。)<br>He didn't say anything about that matter.<br>(Past Negative Plain of 発する)<br>(K2)<br>	[soundfile]
彼は重要な声明を発しました。	(かれはじゅうようなせいめいをはっしました。)<br>He issued an important statement.<br>(Past Positive Polite of 発する)<br>(K2)<br>	[soundfile]
彼らはその問題について議論を発しませんでした。	(かれらはそのもんだいについてぎろんをはっしませんでした。)<br>They didn't discuss the issue.<br>(Past Negative Polite of 発する)<br>(K2)<br>	[soundfile]
彼は音声メッセージを発しています。	(かれはおんせいメッセージをはっしています。)<br>He is sending a voice message.<br>(-te Form of 発する)<br>(K2)<br>	[soundfile]
新しいプロジェクトのアイデアを発そう！	(あたらしいぷろじぇくとのあいであをはっそう！)<br>Let's come up with ideas for the new project!<br>(Volitional of 発する)<br>(K2)<br>	[soundfile]
彼女は緊張せずに意見を発できる。	(かのじょはきんちょうせずにいけんをはつできる。)<br>She can express her opinions without feeling nervous.<br>(Potential of 発する)<br>(K2)<br>	[soundfile]
そのニュースは広く報道され、注目を集めました。	(そのにゅーすはひろくほうどうされ、ちゅうもくをあつめました。)<br>The news was widely reported and attracted attention.<br>(Passive of 発する)<br>(K2)<br>	[soundfile]
私は彼に提案を発させます。	(わたしはかれにていあんをはっさせます。)<br>I will make him propose.<br>(Causative of 発する)<br>(K2)<br>	[soundfile]
その問題について議論を発せよ！	(そのもんだいについてぎろんをはっせよ！)<br>Let's discuss the issue!<br>(Imperative of 発する)<br>(K2)<br>	[soundfile]
もし彼が意見を発すれば、私たちはそれに対処する必要があります。	(もしこじょがいけんをはっすれば、わたしたちはそれにたいしょするひつようがあります。)<br>If he expresses his opinion, we need to address it.<br>(Conditional of 発する)<br>(K2)<br>	[soundfile]
法律に従わない者を罰する。	(ほうりつにしたがわないものをばっする。)<br>Punish those who do not obey the law.<br>(Present Positive Plain of 罰する)<br>(K3)<br>	[soundfile]
彼は間違いを犯しても自分を罰しない。	(かれはまちがいをおかしてもじぶんをばっしない。)<br>He doesn't punish himself even when he makes mistakes.<br>(Present Negative Plain of 罰する)<br>(K3)<br>	[soundfile]
学校ではルールを破った生徒を罰します。	(がっこうではるーるをやぶったせいとをばっします。)<br>The school punishes students who break the rules.<br>(Present Positive Polite of 罰する)<br>(K3)<br>	[soundfile]
彼女は子供たちを厳しく罰しません。	(かのじょはこどもたちをきびしくばっしません。)<br>She does not punish the children severely.<br>(Present Negative Polite of 罰する)<br>(K3)<br>	[soundfile]
彼は悪い行為をした者を罰した。	(かれはわるいこういをしたものをばっした。)<br>He punished those who did wrong.<br>(Past Positive Plain of 罰する)<br>(K3)<br>	[soundfile]
規則違反をしたが、彼は罰さなかった。	(きそくいはんをしたが、かれはばっさなかった。)<br>He didn't punish despite the rule violation.<br>(Past Negative Plain of 罰する)<br>(K3)<br>	[soundfile]
先週、彼らは問題を起こした従業員を罰しました。	(せんしゅう、かれらはもんだいをおこしたじゅうぎょういんをばっしました。)<br>Last week, they punished the employee who caused the problem.<br>(Past Positive Polite of 罰する)<br>(K3)<br>	[soundfile]
会社は一部の社員を罰しませんでした。	(かいしゃはいちぶのしゃいんをばっしませんでした。)<br>The company did not punish some employees.<br>(Past Negative Polite of 罰する)<br>(K3)<br>	[soundfile]
規則を破った学生を罰しています。	(きそくをやぶったがくせいをばっしています。)<br>They are punishing students who broke the rules.<br>(-te Form of 罰する)<br>(K3)<br>	[soundfile]
私たちはルールを守らない者たちを罰そう！	(わたしたちはるーるをまもらないものたちをばっそう！)<br>Let's punish those who do not follow the rules!<br>(Volitional of 罰する)<br>(K3)<br>	[soundfile]
その先生は生徒を厳しく罰できる。	(そのせんせいはせいとをきびしくばっできる。)<br>The teacher can punish the students severely.<br>(Potential of 罰する)<br>(K3)<br>	[soundfile]
彼はルール違反が発覚し、罰された。	(かれはるーるいはんがはっかくし、ばっされた。)<br>He was caught breaking the rules and punished.<br>(Passive of 罰する)<br>(K3)<br>	[soundfile]
私は彼にその行動の結果を受け入れさせ、罰させるつもりです。	(わたしはかれにそのこうどうのけっかをうけいれさせ、ばっさせるつもりです。)<br>I intend to make him accept the consequences of his actions and punish him.<br>(Causative of 罰する)<br>(K3)<br>	[soundfile]
違反者を厳しく罰せよ！	(いはんしゃをきびしくばっせよ！)<br>Punish the violators severely!<br>(Imperative of 罰する)<br>(K3)<br>	[soundfile]
もし規則を破ったならば、罰すればいい。	(もしきそくをやぶったならば、ばっすればいい。)<br>If you break the rules, you should be punished.<br>(Conditional of 罰する)<br>(K3)<br>	[soundfile]
彼は地図で目的地を指す。	(かれはちずでもくてきちをさす。)<br>He points to the destination on the map.<br>(Present Positive Plain of 指す)<br>(L1)<br>	[soundfile]
彼女は決して他人を指さない。	(かのじょはけっしてたにんをささない。)<br>She never points at others.<br>(Present Negative Plain of 指す)<br>(L1)<br>	[soundfile]
ツアーガイドは興味深い場所を指します。	(つあーがいどはきょうみぶかいばしょをさします。)<br>The tour guide points out interesting places.<br>(Present Positive Polite of 指す)<br>(L1)<br>	[soundfile]
彼は周囲の人々を指しませんでした。	(かれはしゅういのひとびとをさしませんでした。)<br>He didn't point at the people around him.<br>(Present Negative Polite of 指す)<br>(L1)<br>	[soundfile]
私は地図で彼に道を指した。	(わたしはちずでかれにみちをさした。)<br>I pointed him the way on the map.<br>(Past Positive Plain of 指す)<br>(L1)<br>	[soundfile]
彼らは正しい方向を指さなかった。	(かれらはただしいほうこうをささなかった。)<br>They didn't point in the right direction.<br>(Past Negative Plain of 指す)<br>(L1)<br>	[soundfile]
先生は私たちに正解を指しました。	(せんせいはわたしたちにせいかいをさしました。)<br>The teacher pointed out the correct answer to us.<br>(Past Positive Polite of 指す)<br>(L1)<br>	[soundfile]
彼はその場所を指しませんでした。	(かれはそのばしょをさしませんでした。)<br>He didn't point at the place.<br>(Past Negative Polite of 指す)<br>(L1)<br>	[soundfile]
彼は遠くの山を指して話しました。	(かれはとおくのやまをさしてはなしました。)<br>He pointed to the distant mountain as he spoke.<br>(-te Form of 指す)<br>(L1)<br>	[soundfile]
この方向を指そう！	(このほうこうをさそう！)<br>Let's point in this direction!<br>(Volitional of 指す)<br>(L1)<br>	[soundfile]
彼は遠くの星を指せる。	(かれはとおくのほしをさせる。)<br>He can point to the distant stars.<br>(Potential of 指す)<br>(L1)<br>	[soundfile]
私の名前が指されていた。	(わたしのなまえがさされていた。)<br>My name was mentioned.<br>(Passive of 指す)<br>(L1)<br>	[soundfile]
彼は私にその建物を指させた。	(かれはわたしにそのたてものをささせた。)<br>He made me point to the building.<br>(Causative of 指す)<br>(L1)<br>	[soundfile]
彼女の方を指せ！	(かのじょのほうをさせ！)<br>Point to her!<br>(Imperative of 指す)<br>(L1)<br>	[soundfile]
もし彼が正しい方向を指せば、私たちは進むことができるだろう。	(もしこじょがただしいほうこうをさせば、わたしたちはすすむことができるだろう。)<br>If he points in the right direction, we will be able to proceed.<br>(Conditional of 指す)<br>(L1)<br>	[soundfile]
彼は流暢に日本語を話す。	(かれはりゅうちょうににほんごをはなす。)<br>He speaks Japanese fluently.<br>(Present Positive Plain of 話す)<br>(L2)<br>	[soundfile]
彼女は知らないことについては話さない。	(かのじょはしらないことについてははなさない。)<br>She doesn't talk about things she doesn't know.<br>(Present Negative Plain of 話す)<br>(L2)<br>	[soundfile]
先生は生徒たちに物語を話します。	(せんせいはせいとたちにものがたりをはなします。)<br>The teacher tells stories to the students.<br>(Present Positive Polite of 話す)<br>(L2)<br>	[soundfile]
彼は人前で自分のプライベートなことを話しません。	(かれはひとまえでじぶんのぷらいべーとなことをはなしません。)<br>He doesn't talk about his private matters in public.<br>(Present Negative Polite of 話す)<br>(L2)<br>	[soundfile]
昨日、彼女は私に秘密を話した。	(きのう、かのじょはわたしにひみつをはなした。)<br>Yesterday, she told me a secret.<br>(Past Positive Plain of 話す)<br>(L2)<br>	[soundfile]
私は彼に何が起こったか話さなかった。	(わたしはかれになにがおこったかはなさなかった。)<br>I didn't tell him what happened.<br>(Past Negative Plain of 話す)<br>(L2)<br>	[soundfile]
彼は昨日、その事件について警察に話しました。	(かれはきのう、そのじけんについてけいさつにはなしました。)<br>He spoke to the police about the incident yesterday.<br>(Past Positive Polite of 話す)<br>(L2)<br>	[soundfile]
彼らはその問題について何も話しませんでした。	(かれらはそのもんだいについてなにもはなしませんでした。)<br>They didn't talk about the issue at all.<br>(Past Negative Polite of 話す)<br>(L2)<br>	[soundfile]
彼は電話で友達と話しています。	(かれはでんわでともだちとはなしています。)<br>He is talking to his friend on the phone.<br>(-te Form of 話す)<br>(L2)<br>	[soundfile]
新しいプロジェクトについて意見を話そう！	(あたらしいぷろじぇくとについていけんをはなそう！)<br>Let's share opinions about the new project!<br>(Volitional of 話す)<br>(L2)<br>	[soundfile]
彼女は英語を流暢に話せる。	(かのじょはえいごをりゅうちょうにはなせる。)<br>She can speak English fluently.<br>(Potential of 話す)<br>(L2)<br>	[soundfile]
私のことが話されていた。	(わたしのことがはなされていた。)<br>They were talking about me.<br>(Passive of 話す)<br>(L2)<br>	[soundfile]
彼は彼女に自分の気持ちを話させました。	(かれはかのじょにじぶんのきもちをはなさせました。)<br>He made her talk about her feelings.<br>(Causative of 話す)<br>(L2)<br>	[soundfile]
問題があれば、すぐに話せ！	(もんだいがあれば、すぐにはなせ！)<br>Speak up if there's a problem!<br>(Imperative of 話す)<br>(L2)<br>	[soundfile]
もし彼が本当のことを話せば、私たちは彼を信じるでしょう。	(もしこじょがほんとうのことをはなせば、わたしたちはかれをしんじるでしょう。)<br>If he tells the truth, we will believe him.<br>(Conditional of 話す)<br>(L2)<br>	[soundfile]
数字で答えを示す。	(すうじでこたえをしめす。)<br>Show the answer with numbers.<br>(Present Positive Plain of 示す)<br>(L3)<br>	[soundfile]
彼は感情を示さない。	(かれはかんじょうをしめさない。)<br>He doesn't show his emotions.<br>(Present Negative Plain of 示す)<br>(L3)<br>	[soundfile]
説明書が正しい使用方法を示します。	(せつめいしょがただしいしようほうほうをしめします。)<br>The manual shows the correct usage.<br>(Present Positive Polite of 示す)<br>(L3)<br>	[soundfile]
私はその行動で彼の本当の意図を示しませんでした。	(わたしはそのこうどうでかれのほんとうのいとをしめませんでした。)<br>I didn't show his true intentions with that action.<br>(Present Negative Polite of 示す)<br>(L3)<br>	[soundfile]
彼は写真で証拠を示した。	(かれはしゃしんでしょうこをしめした。)<br>He showed evidence in the photo.<br>(Past Positive Plain of 示す)<br>(L3)<br>	[soundfile]
彼女はその事実を示さなかった。	(かのじょはそのじじつをしめさなかった。)<br>She didn't show the fact.<br>(Past Negative Plain of 示す)<br>(L3)<br>	[soundfile]
私たちはグラフで結果を示しました。	(わたしたちはぐらふでけっかをしめました。)<br>We showed the results on the graph.<br>(Past Positive Polite of 示す)<br>(L3)<br>	[soundfile]
その報告書は問題の原因を示しませんでした。	(そのほうこくしょはもんだいのげんいんをしめませんでした。)<br>The report did not indicate the cause of the problem.<br>(Past Negative Polite of 示す)<br>(L3)<br>	[soundfile]
この図表はデータを示しています。	(このずひょうはデータをしめしています。)<br>This chart shows the data.<br>(-te Form of 示す)<br>(L3)<br>	[soundfile]
会議で新しいアイデアを示そう！	(かいぎであたらしいあいであをしめそう！)<br>Let's present new ideas at the meeting!<br>(Volitional of 示す)<br>(L3)<br>	[soundfile]
彼は物理的な証拠を示せる。	(かれはぶつりてきなしょうこをしめせる。)<br>He can present physical evidence.<br>(Potential of 示す)<br>(L3)<br>	[soundfile]
その写真は証拠として裁判で示された。	(そのしゃしんはしょうことしてさいばんでしめされた。)<br>The photo was presented as evidence in court.<br>(Passive of 示す)<br>(L3)<br>	[soundfile]
私は彼に手順を再度示させました。	(わたしはかれにてじゅんをさいどしめさせました。)<br>I made him show the procedure again.<br>(Causative of 示す)<br>(L3)<br>	[soundfile]
この実験結果を示せ！	(このじっけんけっかをしめせ！)<br>Show the results of this experiment!<br>(Imperative of 示す)<br>(L3)<br>	[soundfile]
もし彼女が証拠を示せば、私たちは彼女を信じるだろう。	(もしこじょがしょうこをしめせば、わたしたちはかのじょをしんじるだろう。)<br>If she shows the evidence, we will believe her.<br>(Conditional of 示す)<br>(L3)<br>	[soundfile]
彼は彼女を愛する。	(かれはかのじょをあいする。)<br>He loves her.<br>(Present Positive Plain of 愛する)<br>(M1)<br>	[soundfile]
彼女はその男性を愛さない。	(かのじょはそのだんせいをあいさない。)<br>She doesn't love the man.<br>(Present Negative Plain of 愛する)<br>(M1)<br>	[soundfile]
私は家族を愛します。	(わたしはかぞくをあいします。)<br>I love my family.<br>(Present Positive Polite of 愛する)<br>(M1)<br>	[soundfile]
彼は自分自身を愛しません。	(かれはじぶんじしんをあいしません。)<br>He doesn't love himself.<br>(Present Negative Polite of 愛する)<br>(M1)<br>	[soundfile]
彼は過去にその女性を愛した。	(かれはかこにそのじょせいをあいした。)<br>He loved the woman in the past.<br>(Past Positive Plain of 愛する)<br>(M1)<br>	[soundfile]
彼女はその犬を愛さなかった。	(かのじょはそのいぬをあいさなかった。)<br>She didn't love the dog.<br>(Past Negative Plain of 愛する)<br>(M1)<br>	[soundfile]
私たちは昔、同じ夢を愛しました。	(わたしたちはむかし、おなじゆめをあいしました。)<br>We loved the same dream in the past.<br>(Past Positive Polite of 愛する)<br>(M1)<br>	[soundfile]
彼らは長い間、お互いを愛しませんでした。	(かれらはながいあいだ、おたがいをあいしませんでした。)<br>They didn't love each other for a long time.<br>(Past Negative Polite of 愛する)<br>(M1)<br>	[soundfile]
彼女は毎日彼に愛していると伝える。	(かのじょはまいにちかれにあいしているとつたえる。)<br>She tells him she loves him every day.<br>(-te Form of 愛する)<br>(M1)<br>	[soundfile]
彼らは新しい生活を愛しようとしています。	(かれらはあたらしいせいかつをあいしようとしています。)<br>They are trying to love their new life.<br>(Volitional of 愛する)<br>(M1)<br>	[soundfile]
彼は深く愛せる人だ。	(かれはふかくあいせるひとだ。)<br>He is someone who can love deeply.<br>(Potential of 愛する)<br>(M1)<br>	[soundfile]
彼女は彼に愛されることに感謝している。	(かのじょはかれにあいされることにかんしゃしている。)<br>She is grateful to be loved by him.<br>(Passive of 愛する)<br>(M1)<br>	[soundfile]
彼は私に多くのことを愛させた。	(かれはわたしにおおくのことをあいさせた。)<br>He made me love many things.<br>(Causative of 愛する)<br>(M1)<br>	[soundfile]
人々を愛せ！	(ひとびとをあいせ！)<br>Love people!<br>(Imperative of 愛する)<br>(M1)<br>	[soundfile]
もし本当に彼女を愛せば、彼は彼女のために何でもできるだろう。	(もしほんとうにかのじょをあいせば、かれはかのじょのためになんでもできるだろう。)<br>If he truly loves her, he would do anything for her.<br>(Conditional of 愛する)<br>(M1)<br>	[soundfile]
彼女は日々進化する。	(かのじょはひびしんかする。)<br>She evolves every day.<br>(Present Positive Plain of 化する)<br>(M2)<br>	[soundfile]
その問題は化さないままだ。	(そのもんだいはかさないままだ。)<br>The issue remains unresolved.<br>(Present Negative Plain of 化する)<br>(M2)<br>	[soundfile]
科学技術は急速に進化します。	(かがくぎじゅつはきゅうそくにしんかします。)<br>Science and technology are evolving rapidly.<br>(Present Positive Polite of 化する)<br>(M2)<br>	[soundfile]
彼らは環境への影響を無視して化しません。	(かれらはかんきょうへのえいきょうをむししてかしません。)<br>They do not ignore the impact on the environment.<br>(Present Negative Polite of 化する)<br>(M2)<br>	[soundfile]
その地域は大きな変化を経験して化した。	(そのちいきはおおきなへんかをけいけんしてかした。)<br>The region underwent significant changes and transformed.<br>(Past Positive Plain of 化する)<br>(M2)<br>	[soundfile]
彼の計画は実行されず、化さなかった。	(かれのけいかくはじっこうされず、かさなかった。)<br>His plan was not implemented and did not change.<br>(Past Negative Plain of 化する)<br>(M2)<br>	[soundfile]
この地域は最近、大きな変化を経験しました。	(このちいきはさいきん、おおきなへんかをけいけんしました。)<br>This area has recently undergone significant changes.<br>(Past Positive Polite of 化する)<br>(M2)<br>	[soundfile]
彼女は新しい環境に順応せず、化しませんでした。	(かのじょはあたらしいかんきょうにじゅんのうせず、かしませんでした。)<br>She did not adapt to the new environment and did not change.<br>(Past Negative Polite of 化する)<br>(M2)<br>	[soundfile]
環境の変化に適応して化している。	(かんきょうのへんかにてきおうしてかしている。)<br>Adapting to changes in the environment.<br>(-te Form of 化する)<br>(M2)<br>	[soundfile]
私たちはより良い未来を築くために進化しよう。	(わたしたちはよりよいみらいをきずくためにしんかしよう。)<br>Let's evolve to build a better future.<br>(Volitional of 化する)<br>(M2)<br>	[soundfile]
この新しい技術は産業を変化させる可能性がある。	(このあたらしいぎじゅつはさんぎょうをへんかさせるかのうせいがある。)<br>This new technology has the potential to transform industries.<br>(Potential of 化する)<br>(M2)<br>	[soundfile]
そのプロジェクトは急速な変化によって化された。	(そのぷろじぇくとはきゅうそくなへんかによってかされた。)<br>The project was transformed by rapid changes.<br>(Passive of 化する)<br>(M2)<br>	[soundfile]
彼は会社の方針を変化させた。	(かれはかいしゃのほうしんをへんかさせた。)<br>He changed the company's policy.<br>(Causative of 化する)<br>(M2)<br>	[soundfile]
社会の進歩に貢献するために進化せよ！	(しゃかいのしんぽにこうけんするためにしんかせよ！)<br>Evolve to contribute to the progress of society!<br>(Imperative of 化する)<br>(M2)<br>	[soundfile]
もし環境が変化すれば、生態系もそれに応じて化せばよい。	(もしくんきょうがへんかすれば、せいたいけいもそれにおうじてかせばよい。)<br>If the environment changes, ecosystems should also adapt and evolve accordingly.<br>(Conditional of 化する)<br>(M2)<br>	[soundfile]
その問題は地域の管轄に属する。	(そのもんだいはちいきのかんかつにぞくする。)<br>The issue falls under the jurisdiction of the region.<br>(Present Positive Plain of 属する)<br>(M3)<br>	[soundfile]
その事件は彼の管轄には属さない。	(そのじけんはかれのかんかつにはぞくさない。)<br>The case does not fall under his jurisdiction.<br>(Present Negative Plain of 属する)<br>(M3)<br>	[soundfile]
このプロジェクトはIT部門に属します。	(このぷろじぇくとはアイティーぶもんにぞくします。)<br>This project belongs to the IT department.<br>(Present Positive Polite of 属する)<br>(M3)<br>	[soundfile]
その責任は彼らには属しません。	(そのせきにんはかれらにはぞくしません。)<br>That responsibility does not belong to them.<br>(Present Negative Polite of 属する)<br>(M3)<br>	[soundfile]
その土地は昔、その国に属した。	(そのとちはむかし、そのくににぞくした。)<br>The land belonged to that country in the past.<br>(Past Positive Plain of 属する)<br>(M3)<br>	[soundfile]
そのグループは彼の指導の下で属さなかった。	(そのぐるーぷはかれのしどうのしたでぞくさなかった。)<br>The group did not belong under his leadership.<br>(Past Negative Plain of 属する)<br>(M3)<br>	[soundfile]
彼は昨年、その会社に属しました。	(かれはさくねん、そのかいしゃにぞくしました。)<br>He belonged to the company last year.<br>(Past Positive Polite of 属する)<br>(M3)<br>	[soundfile]
その問題は彼には属しませんでした。	(そのもんだいはかれにはぞくしませんでした。)<br>The issue did not belong to him.<br>(Past Negative Polite of 属する)<br>(M3)<br>	[soundfile]
そのプロジェクトはどの部門に属していますか？	(そのぷろじぇくとはどのぶもんにぞくしていますか？)<br>Which department does the project belong to?<br>(-te Form of 属する)<br>(M3)<br>	[soundfile]
新しいチームに属しようとしています。	(あたらしいちーむにぞくしようとしています。)<br>I'm trying to join the new team.<br>(Volitional of 属する)<br>(M3)<br>	[soundfile]
彼はそのクラブの一員になる資格があると考えられています。	(かれはそのくらぶのいちいんになるしかくがあるとかんがえられています。)<br>He is considered qualified to become a member of the club.<br>(Potential of 属する)<br>(M3)<br>	[soundfile]
彼女は新しいグループに属されました。	(かのじょはあたらしいぐるーぷにぞくされました。)<br>She was assigned to the new group.<br>(Passive of 属する)<br>(M3)<br>	[soundfile]
彼は私たちを新しいプロジェクトに属させました。	(かれはわたしたちをあたらしいぷろじぇくとにぞくさせました。)<br>He assigned us to the new project.<br>(Causative of 属する)<br>(M3)<br>	[soundfile]
このグループに属せ！	(このぐるーぷにぞくせ！)<br>Belong to this group!<br>(Imperative of 属する)<br>(M3)<br>	[soundfile]
もし彼がその部門に属せば、彼の能力を活かすことができるだろう。	(もしこじょうがそのぶもんにぞくせば、かれののうりょくをいかすことができるだろう。)<br>If he belongs to that department, he can utilize his abilities.<br>(Conditional of 属する)<br>(M3)<br>	[soundfile]
彼女は彼を待つ。	(かのじょはかれをまつ。)<br>She waits for him.<br>(Present Positive Plain of 待つ)<br>(N1)<br>	[soundfile]
私は決して人を待たない。	(わたしはけっしてひとをまたない。)<br>I never wait for people.<br>(Present Negative Plain of 待つ)<br>(N1)<br>	[soundfile]
会議が始まるのを待ちます。	(かいぎがはじまるのをまちます。)<br>I'll wait for the meeting to start.<br>(Present Positive Polite of 待つ)<br>(N1)<br>	[soundfile]
彼は遅刻したらすぐに謝罪するのを待ちませんでした。	(かれはちこくしたらすぐにしゃざいするのをまちませんでした。)<br>He didn't wait to apologize as soon as he was late.<br>(Present Negative Polite of 待つ)<br>(N1)<br>	[soundfile]
私は彼女が来るのを待った。	(わたしはかのじょがくるのをまった。)<br>I waited for her to come.<br>(Past Positive Plain of 待つ)<br>(N1)<br>	[soundfile]
彼らは待たなかった。	(かれらはまたなかった。)<br>They didn't wait.<br>(Past Negative Plain of 待つ)<br>(N1)<br>	[soundfile]
彼は私たちが到着するのを待ちました。	(かれはわたしたちがとうちゃくするのをまちました。)<br>He waited for us to arrive.<br>(Past Positive Polite of 待つ)<br>(N1)<br>	[soundfile]
彼女は彼の連絡を待ちませんでした。	(かのじょはかれのれんらくをまちませんでした。)<br>She didn't wait for his contact.<br>(Past Negative Polite of 待つ)<br>(N1)<br>	[soundfile]
ここで待っていてください。	(ここでまっていてください。)<br>Please wait here.<br>(-te Form of 待つ)<br>(N1)<br>	[soundfile]
彼らは結果を見るために待とうとしています。	(かれらはけっかをみるためにまとうとしています。)<br>They are trying to wait to see the results.<br>(Volitional of 待つ)<br>(N1)<br>	[soundfile]
その列は長すぎて待てない。	(そのれつはながすぎてまてない。)<br>The line is too long to wait.<br>(Potential of 待つ)<br>(N1)<br>	[soundfile]
彼は毎晩彼女に待たれる。	(かれはまいばんかのじょにまたれる。)<br>He is waited for by her every night.<br>(Passive of 待つ)<br>(N1)<br>	[soundfile]
私は彼を1時間も待たせた。	(わたしはかれをいちじかんもまたせた。)<br>I made him wait for an hour.<br>(Causative of 待つ)<br>(N1)<br>	[soundfile]
待てば良いことがあるかもしれない。	(まてばいいことがあるかもしれない。)<br>Good things may come to those who wait.<br>(Imperative of 待つ)<br>(N1)<br>	[soundfile]
もし彼が戻ってくるなら、私たちは彼を待てばよい。	(もしこじょがもどってくるなら、わたしたちはかれをまてばよい。)<br>If he comes back, we should wait for him.<br>(Conditional of 待つ)<br>(N1)<br>	[soundfile]
彼は大切な品を持つ。	(かれはたいせつなしなをもつ。)<br>He has important items.<br>(Present Positive Plain of 持つ)<br>(N2)<br>	[soundfile]
私は常に財布を持たない。	(わたしはつねにさいふをもたない。)<br>I never carry a wallet.<br>(Present Negative Plain of 持つ)<br>(N2)<br>	[soundfile]
彼はいつもスマートフォンを持ちます。	(かれはいつもすまーとふぉんをもちます。)<br>He always carries his smartphone.<br>(Present Positive Polite of 持つ)<br>(N2)<br>	[soundfile]
彼女は身軽で、たいてい荷物を持ちません。	(かのじょはみがるで、たいていにもつをもちません。)<br>She travels light and usually doesn't carry much luggage.<br>(Present Negative Polite of 持つ)<br>(N2)<br>	[soundfile]
私はその箱を持った。	(わたしはそのはこをもった。)<br>I held the box.<br>(Past Positive Plain of 持つ)<br>(N2)<br>	[soundfile]
彼らは必要な書類を持たなかった。	(かれらはひつようなしょるいをもたなかった。)<br>They didn't have the necessary documents.<br>(Past Negative Plain of 持つ)<br>(N2)<br>	[soundfile]
彼はパーティーで責任を持ちました。	(かれはぱーてぃーでせきにんをもちました。)<br>He took responsibility at the party.<br>(Past Positive Polite of 持つ)<br>(N2)<br>	[soundfile]
彼女はそのプロジェクトの進行状況を持ちませんでした。	(かのじょはそのぷろじぇくとのしんこうじょうきょうをもちませんでした。)<br>She didn't keep track of the project's progress.<br>(Past Negative Polite of 持つ)<br>(N2)<br>	[soundfile]
重い荷物を持っていると背中が痛くなります。	(おもいにもつをもっているとせなかがいたくなります。)<br>Your back hurts when you carry heavy luggage.<br>(-te Form of 持つ)<br>(N2)<br>	[soundfile]
より多くの責任を持とう。	(よりおおくのせきにんをもとう。)<br>Let's take on more responsibility.<br>(Volitional of 持つ)<br>(N2)<br>	[soundfile]
彼は多くの仕事を同時に持てる。	(かれはおおくのしごとをどうじにもてる。)<br>He can handle many tasks simultaneously.<br>(Potential of 持つ)<br>(N2)<br>	[soundfile]
彼女はいつも夢の中で手紙を持たれます。	(かのじょはいつもゆめのなかでてがみをもたれます。)<br>She is always holding a letter in her dreams.<br>(Passive of 持つ)<br>(N2)<br>	[soundfile]
私は彼に荷物を持たせた。	(わたしはかれににもつをもたせた。)<br>I made him carry the luggage.<br>(Causative of 持つ)<br>(N2)<br>	[soundfile]
心に希望を持て！	(こころにきぼうをもて！)<br>Have hope in your heart!<br>(Imperative of 持つ)<br>(N2)<br>	[soundfile]
もし彼が正しい態度を持てば、成功するだろう。	(もしこじょがただしいたいどをもてば、せいこうするだろう。)<br>If he adopts the right attitude, he will succeed.<br>(Conditional of 持つ)<br>(N2)<br>	[soundfile]
彼は早く座席から立つ。	(かれははやくざせきからたつ。)<br>He quickly stands up from his seat.<br>(Present Positive Plain of 立つ)<br>(N3)<br>	[soundfile]
風が強すぎて立たない。	(かぜがつよすぎてたたない。)<br>It's too windy to stand.<br>(Present Negative Plain of 立つ)<br>(N3)<br>	[soundfile]
社長が入室すると、みんなが立ちます。	(しゃちょうがにゅうしつすると、みんながたちます。)<br>When the president enters the room, everyone stands up.<br>(Present Positive Polite of 立つ)<br>(N3)<br>	[soundfile]
彼はその問題について立ちません。	(かれはそのもんだいについてたちません。)<br>He doesn't take a stance on the issue.<br>(Present Negative Polite of 立つ)<br>(N3)<br>	[soundfile]
彼は私の隣に立った。	(かれはわたしのとなりにたった。)<br>He stood next to me.<br>(Past Positive Plain of 立つ)<br>(N3)<br>	[soundfile]
彼女は怖くて立たなかった。	(かのじょはこわくてたたなかった。)<br>She was too scared to stand.<br>(Past Negative Plain of 立つ)<br>(N3)<br>	[soundfile]
彼は電車の中で私に席を譲って立ちました。	(かれはでんしゃのなかでわたしにせきをゆずってたちました。)<br>He gave me his seat on the train and stood up.<br>(Past Positive Polite of 立つ)<br>(N3)<br>	[soundfile]
彼はその場で立ちませんでした。	(かれはそのばでたちませんでした。)<br>He didn't stand up on the spot.<br>(Past Negative Polite of 立つ)<br>(N3)<br>	[soundfile]
クラスが始まるとすぐに立ってください。	(くらすがはじまるとすぐにたってください。)<br>Please stand up as soon as the class begins.<br>(-te Form of 立つ)<br>(N3)<br>	[soundfile]
今、立とうとしています。	(いま、たとうとしています。)<br>I'm trying to stand up now.<br>(Volitional of 立つ)<br>(N3)<br>	[soundfile]
彼は一人で立てる。	(かれはひとりでたてる。)<br>He can stand up on his own.<br>(Potential of 立つ)<br>(N3)<br>	[soundfile]
メッセージが全員に読まれると、全員が立たれました。	(めっせーじがぜんいんによまれると、ぜんいんがたたれました。)<br>When the message was read by everyone, everyone stood up.<br>(Passive of 立つ)<br>(N3)<br>	[soundfile]
私は彼を立たせました。	(わたしはかれをたたせました。)<br>I made him stand up.<br>(Causative of 立つ)<br>(N3)<br>	[soundfile]
立て！	(たて！)<br>Stand up!<br>(Imperative of 立つ)<br>(N3)<br>	[soundfile]
もし勇気があれば、立てばいい。	(もしゆうきがあれば、たてばいい。)<br>If you have courage, you should stand up.<br>(Conditional of 立つ)<br>(N3)<br>	[soundfile]
問題がまだ在る。	(もんだいがまだある。)<br>The problem still exists.<br>(Present Positive Plain of 在る)<br>(O1)<br>	[soundfile]
彼の言葉は信頼できるとは在らない。	(かれのことばはしんらいできるとはあらない。)<br>His words cannot be trusted.<br>(Present Negative Plain of 在る)<br>(O1)<br>	[soundfile]
その店では新鮮な魚が常に在ります。	(そのみせではしんせんなさかながつねにあります。)<br>Fresh fish is always available at the store.<br>(Present Positive Polite of 在る)<br>(O1)<br>	[soundfile]
この地域では病院が近くに在りません。	(このちいきではびょういんがちかくにありません。)<br>There is no hospital nearby in this area.<br>(Present Negative Polite of 在る)<br>(O1)<br>	[soundfile]
昔、ここに家が在った。	(むかし、ここにいえがあった。)<br>There used to be a house here.<br>(Past Positive Plain of 在る)<br>(O1)<br>	[soundfile]
彼の名前はリストに在らなかった。	(かれのなまえはりすとにあらなかった。)<br>His name wasn't on the list.<br>(Past Negative Plain of 在る)<br>(O1)<br>	[soundfile]
昨日、そこに彼女が在りました。	(きのう、そこにかのじょがありました。)<br>She was there yesterday.<br>(Past Positive Polite of 在る)<br>(O1)<br>	[soundfile]
その本は図書館に在りませんでした。	(そのほんはとしょかんにありませんでした。)<br>The book wasn't available at the library.<br>(Past Negative Polite of 在る)<br>(O1)<br>	[soundfile]
現在、彼の心には多くの感情が在っている。	(げんざい、かれのこころにはおおくのかんじょうがあっている。)<br>Currently, there are many emotions in his heart.<br>(-te Form of 在る)<br>(O1)<br>	[soundfile]
もっと多くの機会を作り出すために、一緒に努力しようではありませんか。	(もっとおおくのきかいをつくりだすために、いっしょにどりょくしようではありませんか。)<br>Why don't we work together to create more opportunities?<br>(Volitional of 在る)<br>(O1)<br>	[soundfile]
この地域には良い教育機関が在れる。	(このちいきにはよいきょういくきかんがあれる。)<br>There can be good educational institutions in this area.<br>(Potential of 在る)<br>(O1)<br>	[soundfile]
彼らは重要な会議に招待されて在られる。	(かれらはじゅうようなかいぎにしょうたいされてあられる。)<br>They can be invited to important meetings.<br>(Passive of 在る)<br>(O1)<br>	[soundfile]
彼女は彼を新しいプロジェクトに参加させて在らせる。	(かのじょはかれをあたらしいぷろじぇくとにさんかさせてあらせる。)<br>She makes him participate in the new project and be present.<br>(Causative of 在る)<br>(O1)<br>	[soundfile]
勇敢で在れ。	(ゆうかんであれ。)<br>Be brave.<br>(Imperative of 在る)<br>(O1)<br>	[soundfile]
もし時間が在れば、一緒に映画を見に行きませんか？	(もしじかんがあれば、いっしょにえいがをみにいきませんか？)<br>If you have time, would you like to go see a movie together?<br>(Conditional of 在る)<br>(O1)<br>	[soundfile]
彼は日々の問題に直面している。	(かれはひびのもんだいにちめんしている。)<br>He faces daily challenges.<br>(Present Positive Plain of 問う)<br>(P1)<br>	[soundfile]
彼はその意見を疑問視し、問わない。	(かれはそのいけんをぎもんし、とわない。)<br>He questions the opinion and doesn't ask.<br>(Present Negative Plain of 問う)<br>(P1)<br>	[soundfile]
先生に質問を問います。	(せんせいにしつもんをといます。)<br>I ask the teacher a question.<br>(Present Positive Polite of 問う)<br>(P1)<br>	[soundfile]
彼女は彼の決定を疑問視し、問いませんでした。	(かのじょはかれのけっていをぎもんし、といませんでした。)<br>She questioned his decision but didn't ask.<br>(Present Negative Polite of 問う)<br>(P1)<br>	[soundfile]
彼はその問題を解決する方法を彼に問った。	(かれはそのもんだいをかいけつするほうほうをかれにといた。)<br>He asked him about the way to solve the problem.<br>(Past Positive Plain of 問う)<br>(P1)<br>	[soundfile]
私はその出来事の背後にある真実を問わなかった。	(わたしはそのできごとのはいごにあるしんじつをとわなかった。)<br>I didn't inquire about the truth behind the incident.<br>(Past Negative Plain of 問う)<br>(P1)<br>	[soundfile]
彼は上司に計画の進行状況を問いました。	(かれはじょうしにけいかくのしんこうじょうきょうをといました。)<br>He asked his boss about the progress of the plan.<br>(Past Positive Polite of 問う)<br>(P1)<br>	[soundfile]
その問題については彼は何も問いませんでした。	(そのもんだいについてはかれはなにもといませんでした。)<br>He didn't ask anything about the problem.<br>(Past Negative Polite of 問う)<br>(P1)<br>	[soundfile]
彼女は私にその理由を問ってきた。	(かのじょはわたしにそのりゆうをとってきた。)<br>She came to me and asked for the reason.<br>(-te Form of 問う)<br>(P1)<br>	[soundfile]
この問題について一緒に考えてみましょうか？	(このもんだいについていっしょにかんがえてみましょうか？)<br>Shall we try to think about this problem together?<br>(Volitional of 問う)<br>(P1)<br>	[soundfile]
彼は自分の考えに自信を持って問える。	(かれはじぶんのかんがえにじしんをもってとえる。)<br>He can confidently ask about his own thoughts.<br>(Potential of 問う)<br>(P1)<br>	[soundfile]
彼女はいつも質問を問われる。	(かのじょはいつもしつもんをとわれる。)<br>She is always questioned.<br>(Passive of 問う)<br>(P1)<br>	[soundfile]
先生は学生に質問をたくさん問わせる。	(せんせいはがくせいにしつもんをたくさんとわせる。)<br>The teacher makes the students ask a lot of questions.<br>(Causative of 問う)<br>(P1)<br>	[soundfile]
知りたいことがあれば、何でも問え。	(しりたいことがあれば、なんでもとえ。)<br>If you have something you want to know, ask anything.<br>(Imperative of 問う)<br>(P1)<br>	[soundfile]
もし疑問があれば、いつでも私に問えばいい。	(もしぎもんがあれば、いつでもわたしにとえばいい。)<br>If you have any questions, feel free to ask me anytime.<br>(Conditional of 問う)<br>(P1)<br>	[soundfile]
彼は犬を呼ぶ。	(かれはいぬをよぶ。)<br>He calls the dog.<br>(Present Positive Plain of 呼ぶ)<br>(Q1)<br>	[soundfile]
彼は決して私を呼ばない。	(かれはけっしてわたしをよばない。)<br>He never calls me.<br>(Present Negative Plain of 呼ぶ)<br>(Q1)<br>	[soundfile]
彼は友人を呼びます。	(かれはゆうじんをよびます。)<br>He calls his friend.<br>(Present Positive Polite of 呼ぶ)<br>(Q1)<br>	[soundfile]
彼女は彼を呼びません。	(かのじょはかれをよびません。)<br>She doesn't call him.<br>(Present Negative Polite of 呼ぶ)<br>(Q1)<br>	[soundfile]
私は彼女を呼んだ。	(わたしはかのじょをよんだ。)<br>I called her.<br>(Past Positive Plain of 呼ぶ)<br>(Q1)<br>	[soundfile]
彼らは彼を呼ばなかった。	(かれらはかれをよばなかった。)<br>They didn't call him.<br>(Past Negative Plain of 呼ぶ)<br>(Q1)<br>	[soundfile]
彼はタクシーを呼びました。	(かれはたくしーをよびました。)<br>He called a taxi.<br>(Past Positive Polite of 呼ぶ)<br>(Q1)<br>	[soundfile]
私は昨日、彼を呼びませんでした。	(わたしはきのう、かれをよびませんでした。)<br>I didn't call him yesterday.<br>(Past Negative Polite of 呼ぶ)<br>(Q1)<br>	[soundfile]
道で彼を呼んでください。	(みちでかれをよんでください。)<br>Please call him on the street.<br>(-te Form of 呼ぶ)<br>(Q1)<br>	[soundfile]
彼を手伝いに呼ぼう。	(かれをてつだいによぼう。)<br>Let's call him for help.<br>(Volitional of 呼ぶ)<br>(Q1)<br>	[soundfile]
彼はすぐに応答できるように呼べる。	(かれはすぐにおうとうできるようによべる。)<br>He can be called upon for an immediate response.<br>(Potential of 呼ぶ)<br>(Q1)<br>	[soundfile]
彼女は友人から呼ばれました。	(かのじょはゆうじんからよばれました。)<br>She was called by her friend.<br>(Passive of 呼ぶ)<br>(Q1)<br>	[soundfile]
私は彼を彼女の家に呼ばせました。	(わたしはかれをかのじょのいえによばせました。)<br>I had him called to her house.<br>(Causative of 呼ぶ)<br>(Q1)<br>	[soundfile]
すぐに医者を呼べ！	(すぐにいしゃをよべ！)<br>Call a doctor immediately!<br>(Imperative of 呼ぶ)<br>(Q1)<br>	[soundfile]
もし困ったら、いつでも私を呼べばいい。	(もしこまったら、いつでもわたしをよべばいい。)<br>If you're in trouble, you can always call me.<br>(Conditional of 呼ぶ)<br>(Q1)<br>	[soundfile]
彼は毎日新しいことを学ぶ。	(かれはまいにちあたらしいことをまなぶ。)<br>He learns new things every day.<br>(Present Positive Plain of 学ぶ)<br>(Q2)<br>	[soundfile]
彼女は自分の過ちから学ばない。	(かのじょはじぶんのあやまちからまなばない。)<br>She doesn't learn from her mistakes.<br>(Present Negative Plain of 学ぶ)<br>(Q2)<br>	[soundfile]
私は日本語を学びます。	(わたしはにほんごをまなびます。)<br>I study Japanese.<br>(Present Positive Polite of 学ぶ)<br>(Q2)<br>	[soundfile]
彼は授業中には注意を払わず、学びません。	(かれはじゅぎょうちゅうにはちゅういをはらわず、まなびません。)<br>He doesn't pay attention during class and doesn't learn.<br>(Present Negative Polite of 学ぶ)<br>(Q2)<br>	[soundfile]
彼は大学で経済学を学んだ。	(かれはだいがくでけいざいがくをまなんだ。)<br>He studied economics at university.<br>(Past Positive Plain of 学ぶ)<br>(Q2)<br>	[soundfile]
彼はその時の重要性を理解せず、何も学ばなかった。	(かれはそのときのじゅうようせいをりかいせず、なにもまなばなかった。)<br>He didn't understand the importance at that time and didn't learn anything.<br>(Past Negative Plain of 学ぶ)<br>(Q2)<br>	[soundfile]
彼女は留学中に多くのことを学びました。	(かのじょはりゅうがくちゅうにおおくのことをまなびました。)<br>She learned a lot while studying abroad.<br>(Past Positive Polite of 学ぶ)<br>(Q2)<br>	[soundfile]
私はその日の教訓から何も学びませんでした。	(わたしはそのひのきょうくんからなにもまなびませんでした。)<br>I didn't learn anything from the lesson of that day.<br>(Past Negative Polite of 学ぶ)<br>(Q2)<br>	[soundfile]
大学での経験は彼を多くのことを学んでいた。	(だいがくでのけいけんはかれをおおくのことをまんでいた。)<br>His university experience taught him many things.<br>(-te Form of 学ぶ)<br>(Q2)<br>	[soundfile]
この機会に新しいスキルを学ぼう。	(このきかいにあたらしいすきるをまなぼう。)<br>Let's learn new skills on this occasion.<br>(Volitional of 学ぶ)<br>(Q2)<br>	[soundfile]
彼は素早く新しい技術を学べる。	(かれはすばやくあたらしいぎじゅつをまなべる。)<br>He can quickly learn new technologies.<br>(Potential of 学ぶ)<br>(Q2)<br>	[soundfile]
彼女は日々新しい知識を学ばれる。	(かのじょはひびあたらしいちしきをまなばれる。)<br>She is constantly learning new knowledge.<br>(Passive of 学ぶ)<br>(Q2)<br>	[soundfile]
先生は生徒たちに多くのことを学ばせる。	(せんせいはせいとたちにおおくのことをまなばせる。)<br>The teacher makes the students learn many things.<br>(Causative of 学ぶ)<br>(Q2)<br>	[soundfile]
大切なことを学べ！	(たいせつなことをまなべ！)<br>Learn what's important!<br>(Imperative of 学ぶ)<br>(Q2)<br>	[soundfile]
もし時間があれば、新しい言語を学べばいい。	(もしじかんがあれば、あたらしいげんごをまなべばいい。)<br>If you have time, you should learn a new language.<br>(Conditional of 学ぶ)<br>(Q2)<br>	[soundfile]
人々が列に並ぶ。	(ひとびとがれつにならぶ。)<br>People line up in a queue.<br>(Present Positive Plain of 並ぶ)<br>(Q3)<br>	[soundfile]
彼は列に並ばないで先に行った。	(かれはれつにならないでさきにいった。)<br>He didn't line up in the queue and went ahead.<br>(Present Negative Plain of 並ぶ)<br>(Q3)<br>	[soundfile]
レジで商品を並びます。	(れじでしょうひんをならびます。)<br>I line up the goods at the cash register.<br>(Present Positive Polite of 並ぶ)<br>(Q3)<br>	[soundfile]
彼はいつも列に並びません。	(かれはいつもれつにならびません。)<br>He never lines up in the queue.<br>(Present Negative Polite of 並ぶ)<br>(Q3)<br>	[soundfile]
彼女は早く列に並んだ。	(かのじょははやくれつにならんだ。)<br>She lined up in the queue quickly.<br>(Past Positive Plain of 並ぶ)<br>(Q3)<br>	[soundfile]
彼は混雑したレストランには並ばなかった。	(かれはこんざつしたれすとらんにはならなかった。)<br>He didn't line up at the crowded restaurant.<br>(Past Negative Plain of 並ぶ)<br>(Q3)<br>	[soundfile]
あの店では人々が長蛇の列に並びました。	(あのみせではひとびとがちょうだのれつにならびました。)<br>People lined up in a long queue at that store.<br>(Past Positive Polite of 並ぶ)<br>(Q3)<br>	[soundfile]
彼は忙しかったため、レジで並びませんでした。	(かれはいそがしかったため、れじでならびませんでした。)<br>He was too busy, so he didn't line up at the cash register.<br>(Past Negative Polite of 並ぶ)<br>(Q3)<br>	[soundfile]
全員が列に並んで待っています。	(ぜんいんがれつにならんでまっています。)<br>Everyone is lined up and waiting.<br>(-te Form of 並ぶ)<br>(Q3)<br>	[soundfile]
早く列に並ぼう。	(はやくれつにならぼう。)<br>Let's line up quickly.<br>(Volitional of 並ぶ)<br>(Q3)<br>	[soundfile]
この本をジャンル別に並べてください。	(このほんをじゃんるべつにならべてください。)<br>Please arrange this book by genre.<br>(Potential of 並ぶ)<br>(Q3)<br>	[soundfile]
その店ではいつも長い行列が並ばれています。	(そのみせではいつもながいぎょうれつがならばれています。)<br>There is always a long line formed at that store.<br>(Passive of 並ぶ)<br>(Q3)<br>	[soundfile]
私は友人たちをレジで列に並ばせました。	(わたしはゆうじんたちをれじでれつにならばせました。)<br>I made my friends line up at the cash register.<br>(Causative of 並ぶ)<br>(Q3)<br>	[soundfile]
商品をサイズ順に並べてください。	(しょうひんをさいずじゅんにならべてください。)<br>Please line up the items by size.<br>(Imperative of 並ぶ)<br>(Q3)<br>	[soundfile]
もし早く到着すれば、行列に並べばいいですよ。	(もしはやくとうちゃくすれば、ぎょうれつにならべばいいですよ。)<br>If you arrive early, you can line up in the queue.<br>(Conditional of 並ぶ)<br>(Q3)<br>	[soundfile]
彼は家に入る。	(かれはいえにはいる。)<br>He enters the house.<br>(Present Positive Plain of 入る)<br>(R1)<br>	[soundfile]
猫は箱に入らない。	(ねこははこにはいらない。)<br>The cat doesn't enter the box.<br>(Present Negative Plain of 入る)<br>(R1)<br>	[soundfile]
客が店に入ります。	(きゃくがみせにはいります。)<br>The customer enters the store.<br>(Present Positive Polite of 入る)<br>(R1)<br>	[soundfile]
彼は彼女の部屋に入りませんでした。	(かれはかのじょのへやにはりませんでした。)<br>He didn't enter her room.<br>(Present Negative Polite of 入る)<br>(R1)<br>	[soundfile]
私は昨日、公園に入った。	(わたしはきのう、こうえんにはいった。)<br>I entered the park yesterday.<br>(Past Positive Plain of 入る)<br>(R1)<br>	[soundfile]
彼は門を見て、中には入らなかった。	(かれはもんをみて、なかにはいらなかった。)<br>He looked at the gate but didn't enter.<br>(Past Negative Plain of 入る)<br>(R1)<br>	[soundfile]
私は彼の部屋に入りました。	(わたしはかれのへやにはいりました。)<br>I entered his room.<br>(Past Positive Polite of 入る)<br>(R1)<br>	[soundfile]
彼女は試験会場に入りませんでした。	(かのじょはしけんかいじょうにはりませんでした。)<br>She didn't enter the examination hall.<br>(Past Negative Polite of 入る)<br>(R1)<br>	[soundfile]
家に入って、靴を脱いでください。	(いえにはいって、くつをぬいでください。)<br>Please enter the house and take off your shoes.<br>(-te Form of 入る)<br>(R1)<br>	[soundfile]
一緒に海に入ろう。	(いっしょにうみにはいろう。)<br>Let's go into the sea together.<br>(Volitional of 入る)<br>(R1)<br>	[soundfile]
キーを入れてドアを開ける。	(きーをいれてどあをあける。)<br>Put the key in and open the door.<br>(Potential of 入る)<br>(R1)<br>	[soundfile]
部屋に入られると、先生がいらっしゃいました。	(へやにはいられると、せんせいがいらっしゃいました。)<br>When someone entered the room, the teacher was there.<br>(Passive of 入る)<br>(R1)<br>	[soundfile]
私は彼を部屋に入れさせました。	(わたしはかれをへやにいれさせました。)<br>I had him enter the room.<br>(Causative of 入る)<br>(R1)<br>	[soundfile]
中に入れ！	(なかにいれ！)<br>Enter inside!<br>(Imperative of 入る)<br>(R1)<br>	[soundfile]
もし暗くなれば、家に入ればいい。	(もしくらくなれば、いえにはいればいい。)<br>If it gets dark, you should enter the house.<br>(Conditional of 入る)<br>(R1)<br>	[soundfile]
彼は毎日料理を作る。	(かれはまいにちりょうりをつくる。)<br>He cooks every day.<br>(Present Positive Plain of 作る)<br>(R2)<br>	[soundfile]
彼女は時間がないため、朝食を作らない。	(かのじょはじかんがないため、ちょうしょくをつくらない。)<br>She doesn't make breakfast because she doesn't have time.<br>(Present Negative Plain of 作る)<br>(R2)<br>	[soundfile]
私は友達の誕生日にケーキを作ります。	(わたしはともだちのたんじょうびにけーきをつくります。)<br>I make a cake for my friend's birthday.<br>(Present Positive Polite of 作る)<br>(R2)<br>	[soundfile]
今晩、私は夕食を作りません。	(こんばん、わたしはゆうしょくをつくりません。)<br>I won't cook dinner tonight.<br>(Present Negative Polite of 作る)<br>(R2)<br>	[soundfile]
私は昨日、手紙を作った。	(わたしはきのう、てがみをつくった。)<br>I wrote a letter yesterday.<br>(Past Positive Plain of 作る)<br>(R2)<br>	[soundfile]
彼らはお金がなかったので、映画を作らなかった。	(かれらはおかねがなかったので、えいがをつくらなかった。)<br>They didn't make the movie because they didn't have money.<br>(Past Negative Plain of 作る)<br>(R2)<br>	[soundfile]
彼は昨日、美味しい料理を作りました。	(かれはきのう、おいしいりょうりをつくりました。)<br>He made delicious food yesterday.<br>(Past Positive Polite of 作る)<br>(R2)<br>	[soundfile]
彼女は忙しかったので、昨日は晩ご飯を作りませんでした。	(かのじょはいそがしかったので、きのうはばんごはんをつくりませんでした。)<br>She was busy, so she didn't cook dinner yesterday.<br>(Past Negative Polite of 作る)<br>(R2)<br>	[soundfile]
ケーキを作って、パーティーに持っていきました。	(けーきをつくって、ぱーてぃーにもっていきました。)<br>I made a cake and brought it to the party.<br>(-te Form of 作る)<br>(R2)<br>	[soundfile]
明日は一緒に昼食を作ろう。	(あしたはいっしょにちゅうしょくをつくろう。)<br>Let's make lunch together tomorrow.<br>(Volitional of 作る)<br>(R2)<br>	[soundfile]
彼女は美味しい料理が作れる。	(かのじょはおいしいりょうりがつくれる。)<br>She can make delicious food.<br>(Potential of 作る)<br>(R2)<br>	[soundfile]
その映画は有名な監督によって作られました。	(そのえいがはゆうめいなかんとくによってつくられました。)<br>The movie was made by a famous director.<br>(Passive of 作る)<br>(R2)<br>	[soundfile]
私は子供たちに絵を作らせました。	(わたしはこどもたちにえをつくらせました。)<br>I had the children make pictures.<br>(Causative of 作る)<br>(R2)<br>	[soundfile]
早く朝食を作れ！	(はやくちょうしょくをつくれ！)<br>Make breakfast quickly!<br>(Imperative of 作る)<br>(R2)<br>	[soundfile]
もし時間があれば、手作りのプレゼントを作ればいいですよ。	(もしじかんがあれば、てづくりのぷれぜんとをつくればいいですよ。)<br>If you have time, you should make a handmade present.<br>(Conditional of 作る)<br>(R2)<br>	[soundfile]
彼はその秘密を知る。	(かれはそのひみつをしる。)<br>He knows the secret.<br>(Present Positive Plain of 知る)<br>(R3)<br>	[soundfile]
私はその人の名前を知らない。	(わたしはそのひとのなまえをしらない。)<br>I don't know that person's name.<br>(Present Negative Plain of 知る)<br>(R3)<br>	[soundfile]
先生はその情報を知ります。	(せんせいはそのじょうほうをしります。)<br>The teacher knows that information.<br>(Present Positive Polite of 知る)<br>(R3)<br>	[soundfile]
私はその事実を知りませんでした。	(わたしはそのじじつをしりませんでした。)<br>I didn't know that fact.<br>(Present Negative Polite of 知る)<br>(R3)<br>	[soundfile]
彼は昨日、新しい計画を知った。	(かれはきのう、あたらしいけいかくをしった。)<br>He knew about the new plan yesterday.<br>(Past Positive Plain of 知る)<br>(R3)<br>	[soundfile]
私は当時そのニュースを知らなかった。	(わたしはとうじそのニュースをしらなかった。)<br>I didn't know about that news at that time.<br>(Past Negative Plain of 知る)<br>(R3)<br>	[soundfile]
彼女は彼の過去を知りました。	(かのじょはかれのかこをしりました。)<br>She knew about his past.<br>(Past Positive Polite of 知る)<br>(R3)<br>	[soundfile]
彼はそのイベントがあることを知りませんでした。	(かれはそのイベントがあることをしりませんでした。)<br>He didn't know that the event was happening.<br>(Past Negative Polite of 知る)<br>(R3)<br>	[soundfile]
彼は私の秘密を知っています。	(かれはわたしのひみつをしっています。)<br>He knows my secret.<br>(-te Form of 知る)<br>(R3)<br>	[soundfile]
この問題についてもっと知ろう。	(このもんだいについてもっとしろう。)<br>Let's learn more about this issue.<br>(Volitional of 知る)<br>(R3)<br>	[soundfile]
その情報はすぐに知れるでしょう。	(そのじょうほうはすぐにしれるでしょう。)<br>That information will be known soon.<br>(Potential of 知る)<br>(R3)<br>	[soundfile]
彼女の秘密は誰にも知られなかった。	(かのじょのひみつはだれにもしられなかった。)<br>Nobody knew her secret.<br>(Passive of 知る)<br>(R3)<br>	[soundfile]
私は彼に真実を知らせた。	(わたしはかれにしんじつをしらせた。)<br>I informed him of the truth.<br>(Causative of 知る)<br>(R3)<br>	[soundfile]
新しい情報を知れ！	(あたらしいじょうほうをしれ！)<br>Know the new information!<br>(Imperative of 知る)<br>(R3)<br>	[soundfile]
もし彼女のことが気になるなら、彼女に直接聞いてみればいい。	(もしこのかのじょのことがきになるなら、かのじょにちょくせつきいてみればいい。)<br>If you're curious about her, you should ask her directly.<br>(Conditional of 知る)<br>(R3)<br>	[soundfile]
彼はその問題を分かる。	(かれはそのもんだいをわかる。)<br>He understands the problem.<br>(Present Positive Plain of 分かる)<br>(R4)<br>	[soundfile]
私は彼の言葉が全く分からない。	(わたしはかれのことばがまったくわからない。)<br>I don't understand his words at all.<br>(Present Negative Plain of 分かる)<br>(R4)<br>	[soundfile]
先生は生徒たちに優しく説明してくれますので、よく分かります。	(せんせいはせいとたちにやさしくせつめいしてくれますので、よくわかります。)<br>Since the teacher kindly explains to the students, they understand well.<br>(Present Positive Polite of 分かる)<br>(R4)<br>	[soundfile]
この本の内容は難しくて、分かりません。	(このほんのないようはむずかしくて、わかりません。)<br>The contents of this book are difficult, so I don't understand.<br>(Present Negative Polite of 分かる)<br>(R4)<br>	[soundfile]
彼は最終的に彼女の気持ちを分かった。	(かれはさいしゅうてきにかのじょのきもちをわかった。)<br>He finally understood her feelings.<br>(Past Positive Plain of 分かる)<br>(R4)<br>	[soundfile]
私はその指示が分からなかった。	(わたしはそのしじがわからなかった。)<br>I didn't understand those instructions.<br>(Past Negative Plain of 分かる)<br>(R4)<br>	[soundfile]
昨日の説明を聞いたので、問題が分かりました。	(きのうのせつめいをきいたので、もんだいがわかりました。)<br>I understood the problem after listening to yesterday's explanation.<br>(Past Positive Polite of 分かる)<br>(R4)<br>	[soundfile]
彼はその件について何も分かりませんでした。	(かれはそのけんについてなにもわかりませんでした。)<br>He didn't understand anything about that matter.<br>(Past Negative Polite of 分かる)<br>(R4)<br>	[soundfile]
彼は私の気持ちをよく分かっています。	(かれはわたしのきもちをよくわかっています。)<br>He understands my feelings well.<br>(-te Form of 分かる)<br>(R4)<br>	[soundfile]
この問題を一緒に解決しようとしています。一緒に取り組めば、きっと分かろう。	(このもんだいをいっしょにかいけつしようとしています。いっしょにとりくめば、きっとわかろう。)<br>We are trying to solve this problem together. If we work together, we will surely understand.<br>(Volitional of 分かる)<br>(R4)<br>	[soundfile]
その問題は簡単ではないため、人々の間で意見が分かれる。	(そのもんだいはかんたんではないため、ひとびとのあいだでいけんがわかれる。)<br>Because the problem is not easy, opinions are divided among people.<br>(Potential of 分かる)<br>(R4)<br>	[soundfile]
その本は読む人によって異なる解釈で分かれる。	(そのほんはよむひとによってことなるかいしゃくでわかれる。)<br>The book can be understood differently depending on the reader's interpretation.<br>(Passive of 分かる)<br>(R4)<br>	[soundfile]
先生は生徒たちに考えさせて、自分たちで答えを見つけさせることで、問題を分からせる。	(せんせいはせいとたちにかんがえさせて、じぶんたちでこたえをみつけさせることで、もんだいをわからせる。)<br>The teacher makes the students think and find the answers themselves, thus helping them understand the problem.<br>(Causative of 分かる)<br>(R4)<br>	[soundfile]
今すぐ彼に話して、その件を分かれ！	(いますぐかれにはなして、そのけんをわかれ！)<br>Talk to him right now and make him understand the matter!<br>(Imperative of 分かる)<br>(R4)<br>	[soundfile]
もし私たちがこの問題を理解していれば、解決策が見つかるかもしれない。	(もしわたしたちがこのもんだいをりかいしていれば、かいけつさくがみつかるかもしれない。)<br>If we understand this problem, we might find a solution.<br>(Conditional of 分かる)<br>(R4)<br>	[soundfile]
彼は毎朝散歩をなさる。	(かれはまいあささんぽをなさる。)<br>He takes a walk every morning.<br>(Present Positive Plain of なさる)<br>(S1)<br>	[soundfile]
私は彼女がそのようなことをなさらないと信じています。	(わたしはかのじょがそのようなことをなさらないとしんじています。)<br>I believe she doesn't do such things.<br>(Present Negative Plain of なさる)<br>(S1)<br>	[soundfile]
社長は新しいプロジェクトを進行中です。	(しゃちょうはあたらしいぷろじぇくとをしんこうちゅうです。)<br>The president is proceeding with the new project.<br>(Present Positive Polite of なさる)<br>(S1)<br>	[soundfile]
彼女は残業をすることが少なくなりました。	(かのじょはざんぎょうをすることがすくなくなりました。)<br>She does less overtime now.<br>(Present Negative Polite of なさる)<br>(S1)<br>	[soundfile]
先生は昨日、生徒たちの質問に答えをなさった。	(せんせいはきのう、せいとたちのしつもんにこたえをなさった。)<br>The teacher answered the students' questions yesterday.<br>(Past Positive Plain of なさる)<br>(S1)<br>	[soundfile]
私の父は旅行に行くことをしばらくなさらなかった。	(わたしのちちはりょこうにいくことをしばらくなさらなかった。)<br>My father hadn't done traveling for a while.<br>(Past Negative Plain of なさる)<br>(S1)<br>	[soundfile]
上司は私たちに多くの助言をなさいました。	(じょうしはわたしたちにおおくのじょげんをなさいました。)<br>The boss gave us a lot of advice.<br>(Past Positive Polite of なさる)<br>(S1)<br>	[soundfile]
彼はその問題についてコメントをなさいませんでした。	(かれはそのもんだいについてコメントをなさいませんでした。)<br>He didn't make any comments on the issue.<br>(Past Negative Polite of なさる)<br>(S1)<br>	[soundfile]
彼は毎週末ガーデニングをなさっています。	(かれはまいしゅうまつがーでにんぐをなさっています。)<br>He does gardening every weekend.<br>(-te Form of なさる)<br>(S1)<br>	[soundfile]
一緒にプロジェクトを成功させるため、頑張ってなさろう。	(いっしょにぷろじぇくとをせいこうさせるため、がんばってなさろう。)<br>Let's work hard together to make the project successful.<br>(Volitional of なさる)<br>(S1)<br>	[soundfile]
その決定はすでになされました。	(そのけっていはすでになされました。)<br>The decision has already been made.<br>(Potential of なさる)<br>(S1)<br>	[soundfile]
多くの人々が彼女の勇気に感銘を受けられました。	(おおくのひとびとがかのじょのゆうきにかんめいをうけられました。)<br>Many people were impressed by her courage.<br>(Passive of なさる)<br>(S1)<br>	[soundfile]
その役員は新しい計画をチームに実行させることができました。	(そのやくいんはあたらしいけいかくをちーむにじっこうさせることができました。)<br>The executive was able to make the team implement the new plan.<br>(Causative of なさる)<br>(S1)<br>	[soundfile]
今、彼に報告書をなさってください。	(いま、かれにほうこくしょをなさってください。)<br>Now, please submit the report to him.<br>(Imperative of なさる)<br>(S1)<br>	[soundfile]
もし彼がそれをなされば、私たちは大いに感謝します。	(もしこれがそれをなされば、わたしたちはおおいにかんしゃします。)<br>If he does that, we will greatly appreciate it.<br>(Conditional of なさる)<br>(S1)<br>	[soundfile]
先生は生徒たちに多くの励ましを下さる。	(せんせいはせいとたちにおおくのはげましをくださる。)<br>The teacher gives a lot of encouragement to the students.<br>(Present Positive Plain of 下さる)<br>(S2)<br>	[soundfile]
彼は最近、私たちに新しい情報を下さらない。	(かれはさいきん、わたしたちにあたらしいじょうほうをくださらない。)<br>He hasn't given us any new information lately.<br>(Present Negative Plain of 下さる)<br>(S2)<br>	[soundfile]
上司は私たちに詳細な指示を下さいます。	(じょうしはわたしたちにしょうさいなしじをくださいます。)<br>The boss gives us detailed instructions.<br>(Present Positive Polite of 下さる)<br>(S2)<br>	[soundfile]
彼女は最後の締め切りを守るため、延長を下さいません。	(かのじょはさいごのしめきりをまもるため、えんちょうをくださいません。)<br>She doesn't grant extensions to meet the final deadline.<br>(Present Negative Polite of 下さる)<br>(S2)<br>	[soundfile]
おばあさんは私に美味しいお菓子を下さった。	(おばあさんはわたしにおいしいおかしをくださった。)<br>The grandmother gave me delicious sweets.<br>(Past Positive Plain of 下さる)<br>(S2)<br>	[soundfile]
彼は昨日、私たちに何もアドバイスを下さらなかった。	(かれはきのう、わたしたちになにもあどばいすをくださらなかった。)<br>He didn't give us any advice yesterday.<br>(Past Negative Plain of 下さる)<br>(S2)<br>	[soundfile]
先生は私たちに多くのサポートを下さいました。	(せんせいはわたしたちにおおくのさぽーとをくださいました。)<br>The teacher gave us a lot of support.<br>(Past Positive Polite of 下さる)<br>(S2)<br>	[soundfile]
お客様は私たちに質問に答えを下さいませんでした。	(おきゃくさまはわたしたちにしつもんにこたえをくださいませんでした。)<br>The customer didn't give us answers to our questions.<br>(Past Negative Polite of 下さる)<br>(S2)<br>	[soundfile]
彼は私たちに良いアドバイスを下さって、助けてくれました。	(かれはわたしたちによいあどばいすをくださって、たすけてくれました。)<br>He gave us good advice and helped us.<br>(-te Form of 下さる)<br>(S2)<br>	[soundfile]
一緒にこの問題に取り組んで、解決策を見つけて下さろう。	(いっしょにこのもんだいにとりくんで、かいけつさくをみつけてくださろう。)<br>Let's work together on this issue and find a solution.<br>(Volitional of 下さる)<br>(S2)<br>	[soundfile]
彼は困っている人々に多くの支援を下される。	(かれはこまっているひとびとにおおくのしえんをくだされる。)<br>He can provide a lot of support to people in need.<br>(Potential of 下さる)<br>(S2)<br>	[soundfile]
その寄付は地元の団体からたくさんの賞賛を下さられました。	(そのきふはじもとのだんたいからたくさんのしょうさんをくださられました。)<br>The donation received a lot of praise from the local organization.<br>(Passive of 下さる)<br>(S2)<br>	[soundfile]
私たちは彼に多くのアドバイスを下さらせました。	(わたしたちはかれにおおくのあどばいすをくださらせました。)<br>We got him to give us a lot of advice.<br>(Causative of 下さる)<br>(S2)<br>	[soundfile]
今日の会議で、あなたの意見を下さい。	(きょうのかいぎで、あなたのいけんをください。)<br>Please give us your opinion at today's meeting.<br>(Imperative of 下さる)<br>(S2)<br>	[soundfile]
もし彼が手伝って下されば、私たちは早く解決できるかもしれません。	(もし彼がてつだってくだされば、わたしたちははやくかいけつできるかもしれません。)<br>If he helps us, we might be able to solve it quickly.<br>(Conditional of 下さる)<br>(S2)<br>	[soundfile]
彼はよく健康の大切さについて話される。	(かれはよくけんこうのたいせつさについてはなされる。)<br>He often speaks about the importance of health.<br>(Present Positive Plain of 仰る)<br>(S3)<br>	[soundfile]
私は彼がその計画について何も仰らないのが不思議だ。	(わたしはかれがそのけいかくについてなにもおっしゃらないのがふしぎだ。)<br>I find it strange that he hasn't said anything about the plan.<br>(Present Negative Plain of 仰る)<br>(S3)<br>	[soundfile]
社長は重要なポイントについて何度も仰います。	(しゃちょうはじゅうようなぽいんとについてなんどもおっしゃいます。)<br>The president mentions the important points repeatedly.<br>(Present Positive Polite of 仰る)<br>(S3)<br>	[soundfile]
彼女は意見を仰いませんでした。	(かのじょはいけんをおっしゃいませんでした。)<br>She didn't offer any opinions.<br>(Present Negative Polite of 仰る)<br>(S3)<br>	[soundfile]
先生は昨日の授業で新しいプロジェクトについて話を仰った。	(せんせいはきのうのじゅぎょうであたらしいぷろじぇくとについてはなしをおった。)<br>The teacher talked about the new project in yesterday's class.<br>(Past Positive Plain of 仰る)<br>(S3)<br>	[soundfile]
彼は昨日、その問題について何も仰らなかった。	(かれはきのう、そのもんだいについてなにもおっしゃらなかった。)<br>He didn't say anything about the issue yesterday.<br>(Past Negative Plain of 仰る)<br>(S3)<br>	[soundfile]
上司は私たちに新しい方針について説明を仰いました。	(じょうしはわたしたちにあたらしいほうしんについてせつめいをおっしゃいました。)<br>The boss asked us for an explanation about the new policy.<br>(Past Positive Polite of 仰る)<br>(S3)<br>	[soundfile]
その件について彼は何も仰いませんでした。	(そのけんについてかれはなにもおっしゃいませんでした。)<br>He didn't say anything about that matter.<br>(Past Negative Polite of 仰る)<br>(S3)<br>	[soundfile]
彼は私たちにアドバイスを仰ってくれました。	(かれはわたしたちにあどばいすをおってくれました。)<br>He asked for our advice.<br>(-te Form of 仰る)<br>(S3)<br>	[soundfile]
この問題について皆の意見を仰りましょう。	(このもんだいについてみんなのいけんをおりましょう。)<br>Let's ask for everyone's opinion on this issue.<br>(Volitional of 仰る)<br>(S3)<br>	[soundfile]
上司はいつでも相談を仰れる環境を提供してくれる。	(じょうしはいつでもそうだんをおっしゃれるかんきょうをていきょうしてくれる。)<br>The boss provides an environment where we can always ask for advice.<br>(Potential of 仰る)<br>(S3)<br>	[soundfile]
そのリーダーは尊敬され、彼の言葉がしばしば引用されて仰られる。	(そのりーだーはそんけいされ、かれのことばがしばしばいんようされておっしゃられる。)<br>The leader is respected, and his words are often quoted and referred to.<br>(Passive of 仰る)<br>(S3)<br>	[soundfile]
私たちは彼に助言を仰らせることができます。	(わたしたちはかれにじょげんをおらせることができます。)<br>We can ask him for advice.<br>(Causative of 仰る)<br>(S3)<br>	[soundfile]
お手伝いが必要なら、いつでも仰ってください。	(おてつだいがひつようなら、いつでもおっしゃってください。)<br>If you need help, please don't hesitate to ask.<br>(Imperative of 仰る)<br>(S3)<br>	[soundfile]
もし私が彼に相談を仰れば、彼はきっと助けてくれるだろう。	(もしわたしがかれにそうだんをおれば、かれはきっとたすけてくれるだろう。)<br>If I ask him for advice, he will surely help me.<br>(Conditional of 仰る)<br>(S3)<br>	[soundfile]
彼は優れた作家だ。	(かれはすぐれたさっかだ。)<br>He is an excellent writer.<br>(Present Positive Plain of だ)<br>(T1)<br>	[soundfile]
あの車は私の車ではない。	(あのくるまはわたしのくるまではない。)<br>That car is not mine.<br>(Present Negative Plain of だ)<br>(T1)<br>	[soundfile]
その仕事はとても難しいです。	(そのしごとはとてもむずかしいです。)<br>That job is very difficult.<br>(Present Positive Polite of だ)<br>(T1)<br>	[soundfile]
彼はまだここにいません。	(かれはまだここにいません。)<br>He is not here yet.<br>(Present Negative Polite of だ)<br>(T1)<br>	[soundfile]
彼女は昨日元気だった。	(かのじょはきのうげんきだった。)<br>She was energetic yesterday.<br>(Past Positive Plain of だ)<br>(T1)<br>	[soundfile]
その本は私の好きな本ではなかった。	(そのほんはわたしのすきなほんではなかった。)<br>That book wasn't one of my favorites.<br>(Past Negative Plain of だ)<br>(T1)<br>	[soundfile]
この場所は以前は公園でした。	(このばしょはいぜんはこうえんでした。)<br>This place used to be a park.<br>(Past Positive Polite of だ)<br>(T1)<br>	[soundfile]
その説明は役に立ちませんでした。	(そのせつめいはやくにたちませんでした。)<br>That explanation was not helpful.<br>(Past Negative Polite of だ)<br>(T1)<br>	[soundfile]
彼は喜んで参加しました。	(かれはよろこんでさんかしました。)<br>He gladly participated.<br>(-te Form of だ)<br>(T1)<br>	[soundfile]
彼はきっと成功するだろう。	(かれはきっとせいこうするだろう。)<br>He will surely succeed.<br>(Volitional of だ)<br>(T1)<br>	[soundfile]
彼は頭が良いので、多くのことができる。	(かれはあたまがよいので、おおくのことができる。)<br>He is smart, so he can do many things.<br>(Potential of だ)<br>(T1)<br>	[soundfile]
その問題は解決されました。	(そのもんだいはかいけつされました。)<br>The problem has been resolved.<br>(Passive of だ)<br>(T1)<br>	[soundfile]
彼は私を笑わせました。	(かれはわたしをわらわせました。)<br>He made me laugh.<br>(Causative of だ)<br>(T1)<br>	[soundfile]
今、行動するのは最善の選択だろ。	(いま、こうどうするのはさいぜんのせんたくだろ。)<br>Now, taking action is the best choice.<br>(Imperative of だ)<br>(T1)<br>	[soundfile]
もし彼が約束を守るなら、信頼できる人だ。	(もしかれがやくそくをまもるなら、しんらいできるひとだ。)<br>If he keeps his promise, he is a trustworthy person.<br>(Conditional of だ)<br>(T1)<br>	[soundfile]
私は毎日運動する。	(わたしはまいにちうんどうする。)<br>I exercise every day.<br>(Present Positive Plain of する)<br>(U1)<br>	[soundfile]
彼はよく宿題をしない。	(かれはよくしゅくだいをしない。)<br>He often doesn't do his homework.<br>(Present Negative Plain of する)<br>(U1)<br>	[soundfile]
社長は新しいプロジェクトを開始します。	(しゃちょうはあたらしいぷろじぇくとをかいしします。)<br>The president will start a new project.<br>(Present Positive Polite of する)<br>(U1)<br>	[soundfile]
彼女は彼の話を聞きません。	(かのじょはかれのはなしをききません。)<br>She doesn't listen to him.<br>(Present Negative Polite of する)<br>(U1)<br>	[soundfile]
私たちは昨日映画を見に行った。	(わたしたちはきのうえいがをみにいった。)<br>We went to see a movie yesterday.<br>(Past Positive Plain of する)<br>(U1)<br>	[soundfile]
彼はその仕事を終わらせることができなかった。	(かれはそのしごとをおわらせることができなかった。)<br>He couldn't finish the job.<br>(Past Negative Plain of する)<br>(U1)<br>	[soundfile]
先週、彼女は私たちにプレゼンテーションを行いました。	(せんしゅう、かのじょはわたしたちにぷれぜんてーしょんをおこないました。)<br>Last week, she gave a presentation to us.<br>(Past Positive Polite of する)<br>(U1)<br>	[soundfile]
その会議は予定通りには開かれませんでした。	(そのかいぎはよていどおりにはひらかれませんでした。)<br>The meeting didn't take place as scheduled.<br>(Past Negative Polite of する)<br>(U1)<br>	[soundfile]
彼は毎日英語の勉強をしています。	(かれはまいにちえいごのべんきょうをしています。)<br>He studies English every day.<br>(-te Form of する)<br>(U1)<br>	[soundfile]
一緒にその計画を実行しよう。	(いっしょにそのけいかくをじっこうしよう。)<br>Let's implement the plan together.<br>(Volitional of する)<br>(U1)<br>	[soundfile]
彼は困難な問題を解決できる。	(かれはこんなんなもんだいをかいけつできる。)<br>He can solve difficult problems.<br>(Potential of する)<br>(U1)<br>	[soundfile]
その計画はよく議論されました。	(そのけいかくはよくぎろんされました。)<br>The plan was well discussed.<br>(Passive of する)<br>(U1)<br>	[soundfile]
私は彼に手伝わせました。	(わたしはかれにてつだわせました。)<br>I made him help me.<br>(Causative of する)<br>(U1)<br>	[soundfile]
今すぐ行動しろ！	(いますぐこうどうしろ！)<br>Take action now!<br>(Imperative of する)<br>(U1)<br>	[soundfile]
もし彼が言うことを聞けば、うまくいくだろう。	(もしかれがいうことをきけば、うまくいくだろう。)<br>If he listens to what I say, it will go well.<br>(Conditional of する)<br>(U1)<br>	[soundfile]
このアプリを毎日使用する。	(このあぷりをまいにちしようする。)<br>I use this app every day.<br>(Present Positive Plain of 使用する)<br>(U2)<br>	[soundfile]
彼は最新の技術を使用しない。	(かれはさいしんのぎじゅつをしようしない。)<br>He doesn't use the latest technology.<br>(Present Negative Plain of 使用する)<br>(U2)<br>	[soundfile]
そのシステムはセキュリティを確保するために使用します。	(そのしすてむはせきゅりてぃをかくほするためにしようします。)<br>The system is used to ensure security.<br>(Present Positive Polite of 使用する)<br>(U2)<br>	[soundfile]
私はその機能をまだ使用しません。	(わたしはそのきのうをまだしようしません。)<br>I haven't used that feature yet.<br>(Present Negative Polite of 使用する)<br>(U2)<br>	[soundfile]
彼女はその新しい機能を使用した。	(かのじょはそのあたらしいきのうをしようした。)<br>She used the new feature.<br>(Past Positive Plain of 使用する)<br>(U2)<br>	[soundfile]
私たちはその機会を使用しなかった。	(わたしたちはそのきかいをしようしなかった。)<br>We didn't use that opportunity.<br>(Past Negative Plain of 使用する)<br>(U2)<br>	[soundfile]
先週、彼はそのツールを使用しました。	(せんしゅう、かれはそのつーるをしようしました。)<br>Last week, he used that tool.<br>(Past Positive Polite of 使用する)<br>(U2)<br>	[soundfile]
そのソフトウェアは正常に使用しませんでした。	(そのそふとうぇあはせいじょうにしようしませんでした。)<br>The software didn't function properly.<br>(Past Negative Polite of 使用する)<br>(U2)<br>	[soundfile]
彼らはこのアプリをテストに使用しています。	(かれらはこのあぷりをてすとにしようしています。)<br>They are using this app for testing.<br>(-te Form of 使用する)<br>(U2)<br>	[soundfile]
この機会を最大限に使用しよう。	(このきかいをさいだいげんにしようしよう。)<br>Let's make the most of this opportunity.<br>(Volitional of 使用する)<br>(U2)<br>	[soundfile]
このアプリはどんな端末でも使用できる。	(このあぷりはどんなたんまつでもしようできる。)<br>This app can be used on any device.<br>(Potential of 使用する)<br>(U2)<br>	[soundfile]
その言語は世界中で使用されている。	(そのげんごはせかいじゅうでしようされている。)<br>That language is used worldwide.<br>(Passive of 使用する)<br>(U2)<br>	[soundfile]
私は彼にそのツールを使用させた。	(わたしはかれにそのつーるをしようさせた。)<br>I made him use that tool.<br>(Causative of 使用する)<br>(U2)<br>	[soundfile]
この機能を使用しろ！	(このきのうをしようしろ！)<br>Use this function! <br>(Imperative of 使用する)<br>(U2)<br>	[soundfile]
もし彼がそのツールを使用すれば、作業が早く終わるだろう。	(もしかれがそのつーるをしようすれば、さぎょうがはやくおわるだろう。)<br>If he uses that tool, the work will finish quickly.<br>(Conditional of 使用する)<br>(U2)<br>	[soundfile]
このボタンを押すと、結果が表示されます。	(このボタンをおすと、けっかがひょうじされます。)<br>Pressing this button will display the results.<br>(Present Positive Plain of 表示する)<br>(U3)<br>	[soundfile]
彼は感情をあまり表示しない。	(かれはかんじょうをあまりひょうじしない。)<br>He doesn't show his emotions much.<br>(Present Negative Plain of 表示する)<br>(U3)<br>	[soundfile]
このウェブサイトは最新の情報を常に表示します。	(このウェブサイトはさいしんのじょうほうをつねにひょうじします。)<br>This website always displays the latest information.<br>(Present Positive Polite of 表示する)<br>(U3)<br>	[soundfile]
そのエラーメッセージは何も表示しませんでした。	(そのエラーメッセージはなにもひょうじしませんでした。)<br>The error message didn't display anything.<br>(Present Negative Polite of 表示する)<br>(U3)<br>	[soundfile]
彼女は報告書を表示した。	(かのじょはほうこくしょをひょうじした。)<br>She displayed the report.<br>(Past Positive Plain of 表示する)<br>(U3)<br>	[soundfile]
彼はその感情を表示しなかった。	(かれはそのかんじょうをひょうじしなかった。)<br>He didn't show that emotion.<br>(Past Negative Plain of 表示する)<br>(U3)<br>	[soundfile]
先週、彼はプレゼンテーションを表示しました。	(せんしゅう、かれはぷれぜんてーしょんをひょうじしました。)<br>Last week, he displayed the presentation.<br>(Past Positive Polite of 表示する)<br>(U3)<br>	[soundfile]
そのウィンドウは正常に表示しませんでした。	(そのウィンドウはせいじょうにひょうじしませんでした。)<br>The window didn't display properly.<br>(Past Negative Polite of 表示する)<br>(U3)<br>	[soundfile]
その情報を詳しく表示してください。	(そのじょうほうをくわしくひょうじしてください。)<br>Please display the information in detail.<br>(-te Form of 表示する)<br>(U3)<br>	[soundfile]
この機能を使ってデータを表示しよう。	(このきのうをつかってでーたをひょうじしよう。)<br>Let's use this function to display the data.<br>(Volitional of 表示する)<br>(U3)<br>	[soundfile]
このアプリはさまざまなフォーマットでデータを表示できる。	(このアプリはさまざまなふぉーまっとででーたをひょうじできる。)<br>This app can display data in various formats.<br>(Potential of 表示する)<br>(U3)<br>	[soundfile]
ページが正常に表示されませんでした。	(ぺーじがせいじょうにひょうじされませんでした。)<br>The page didn't display properly.<br>(Passive of 表示する)<br>(U3)<br>	[soundfile]
私は彼に報告書を表示させました。	(わたしはかれにほうこくしょをひょうじさせました。)<br>I made him display the report.<br>(Causative of 表示する)<br>(U3)<br>	[soundfile]
この情報をすぐに表示しろ！	(このじょうほうをすぐにひょうじしろ！)<br>Display this information immediately!<br>(Imperative of 表示する)<br>(U3)<br>	[soundfile]
もし正しい設定を行えば、情報が表示されるだろう。	(もしただしいせっていをおこなえば、じょうほうがひょうじされるだろう。)<br>If the correct settings are applied, the information will be displayed.<br>(Conditional of 表示する)<br>(U3)<br>	[soundfile]
友達が私に本をくれる。	(ともだちがわたしにほんをくれる。)<br>My friend gives me a book.<br>(Present Positive Plain of くれる)<br>(V1)<br>	[soundfile]
彼は私に何もくれない。	(かれはわたしになにもくれない。)<br>He doesn't give me anything.<br>(Present Negative Plain of くれる)<br>(V1)<br>	[soundfile]
先生は生徒たちにアドバイスをくれます。	(せんせいはせいとたちにあどばいすをくれます。)<br>The teacher gives advice to the students.<br>(Present Positive Polite of くれる)<br>(V1)<br>	[soundfile]
彼は私に手伝いをしてくれません。	(かれはわたしにてつだいをしてくれません。)<br>He doesn't help me.<br>(Present Negative Polite of くれる)<br>(V1)<br>	[soundfile]
友達が私にプレゼントをくれた。	(ともだちがわたしにぷれぜんとをくれた。)<br>My friend gave me a present.<br>(Past Positive Plain of くれる)<br>(V1)<br>	[soundfile]
彼は私にお金をくれなかった。	(かれはわたしにおかねをくれなかった。)<br>He didn't give me any money.<br>(Past Negative Plain of くれる)<br>(V1)<br>	[soundfile]
先週、彼は私に助けをくれました。	(せんしゅう、かれはわたしにたすけをくれました。)<br>Last week, he helped me.<br>(Past Positive Polite of くれる)<br>(V1)<br>	[soundfile]
彼女は私に時間をくれませんでした。	(かのじょはわたしにじかんをくれませんでした。)<br>She didn't give me any time.<br>(Past Negative Polite of くれる)<br>(V1)<br>	[soundfile]
彼は私に手紙を書いてくれてありがとうと言った。	(かれはわたしにてがみをかいてくれてありがとうといった。)<br>He said thank you for writing the letter for me.<br>(-te Form of くれる)<br>(V1)<br>	[soundfile]
この問題についてアドバイスをしてくれよう。	(このもんだいについてあどばいすをしてくれよう。)<br>Let's give advice about this issue.<br>(Volitional of くれる)<br>(V1)<br>	[soundfile]
彼女はいつでも手助けしてくれる。	(かのじょはいつでもてつだってくれる。)<br>She can always help me.<br>(Potential of くれる)<br>(V1)<br>	[soundfile]
お祖母さんにお金をくれられました。	(おばあさんにおかねをくれられました。)<br>I was given money by my grandmother.<br>(Passive of くれる)<br>(V1)<br>	[soundfile]
彼は私に笑わせてくれました。	(かれはわたしにわらわせてくれました。)<br>He made me laugh.<br>(Causative of くれる)<br>(V1)<br>	[soundfile]
その本を貸してくれ。	(そのほんをかしてくれ。)<br>Please lend me that book.<br>(Imperative of くれる)<br>(V1)<br>	[soundfile]
もし時間があれば、手伝ってくれればいいのに。	(もしじかんがあれば、てつだってくれればいいのに。)<br>If you have time, it would be nice if you could help.<br>(Conditional of くれる)<br>(V1)<br>	[soundfile]
彼はいつも丁寧に手紙を書いて呉れる。	(かれはいつもていねいにてがみをかいてくれる。)<br>He always kindly writes letters for me.<br>(Present Positive Plain of 呉れる)<br>(V2)<br>	[soundfile]
彼女は私には何も呉れない。	(かのじょはわたしにはなにもくれない。)<br>She doesn't give me anything.<br>(Present Negative Plain of 呉れる)<br>(V2)<br>	[soundfile]
先生は生徒に忠告をして呉れます。	(せんせいはせいとにちゅうこくをしてくれます。)<br>The teacher kindly gives advice to the students.<br>(Present Positive Polite of 呉れる)<br>(V2)<br>	[soundfile]
彼は私に手伝いをして呉れません。	(かれはわたしにてつだいをしてくれません。)<br>He doesn't kindly help me.<br>(Present Negative Polite of 呉れる)<br>(V2)<br>	[soundfile]
友達が私にプレゼントを買って呉れた。	(ともだちがわたしにぷれぜんとをかってくれた。)<br>My friend kindly bought a present for me.<br>(Past Positive Plain of 呉れる)<br>(V2)<br>	[soundfile]
彼は私にお金を貸して呉れなかった。	(かれはわたしにおかねをかしてくれなかった。)<br>He didn't kindly lend me any money.<br>(Past Negative Plain of 呉れる)<br>(V2)<br>	[soundfile]
先週、彼女は私に手伝いをして呉れました。	(せんしゅう、かのじょはわたしにてつだいをしてくれました。)<br>Last week, she kindly helped me.<br>(Past Positive Polite of 呉れる)<br>(V2)<br>	[soundfile]
彼は私に時間を貸して呉れませんでした。	(かれはわたしにじかんをかしてくれませんでした。)<br>He didn't kindly lend me any time.<br>(Past Negative Polite of 呉れる)<br>(V2)<br>	[soundfile]
彼はいつも私に手伝って呉れてありがとうと言う。	(かれはいつもわたしにてつだってくれてありがとうという。)<br>He always says thank you for kindly helping me.<br>(-te Form of 呉れる)<br>(V2)<br>	[soundfile]
この問題について手伝って呉れよう。	(このもんだいについててつだってくれよう。)<br>Let's kindly help with this issue.<br>(Volitional of 呉れる)<br>(V2)<br>	[soundfile]
彼はいつでも助けて呉れる。	(かれはいつでもたすけてくれる。)<br>He can always kindly help.<br>(Potential of 呉れる)<br>(V2)<br>	[soundfile]
お母さんに料理を作って呉れられました。	(おかあさんにりょうりをつくってくれられました。)<br>I was kindly cooked for by my mother.<br>(Passive of 呉れる)<br>(V2)<br>	[soundfile]
彼は私に笑わせて呉れました。	(かれはわたしにわらわせてくれました。)<br>He made me laugh kindly.<br>(Causative of 呉れる)<br>(V2)<br>	[soundfile]
その本を貸して呉れ。	(そのほんをかしてくれ。)<br>Please kindly lend me that book.<br>(Imperative of 呉れる)<br>(V2)<br>	[soundfile]
もし時間があれば、手伝って呉れればありがたい。	(もしじかんがあれば、てつだってくれればありがたい。)<br>If you have time, it would be appreciated if you could kindly help.<br>(Conditional of 呉れる)<br>(V2)<br>	[soundfile]
机の上に本がある。	(つくえのうえにほんがある。)<br>There is a book on the desk.<br>(Present Positive Plain of ある)<br>(W1)<br>	[soundfile]
彼の家にはペットがない。	(かれのいえにはぺっとがない。)<br>There are no pets in his house.<br>(Present Negative Plain of ある)<br>(W1)<br>	[soundfile]
この地域には多くの観光スポットがあります。	(このちいきにはおおくのかんこうすぽっとがあります。)<br>There are many tourist spots in this area.<br>(Present Positive Polite of ある)<br>(W1)<br>	[soundfile]
この問題の解決策はまだありません。	(このもんだいのかいけつさくはまだありません。)<br>There is still no solution to this problem.<br>(Present Negative Polite of ある)<br>(W1)<br>	[soundfile]
昨日、ここに彼がいると思ったが、彼はもういなかった。	(きのう、ここにかれがいるとおもったが、かれはもういなかった。)<br>Yesterday, I thought he was here, but he was already gone.<br>(Past Positive Plain of ある)<br>(W1)<br>	[soundfile]
昨日の会議には彼女はいなかった。	(きのうのかいぎにはかのじょはいなかった。)<br>She wasn't present at yesterday's meeting.<br>(Past Negative Plain of ある)<br>(W1)<br>	[soundfile]
その時、たくさんの人が救助活動に参加していました。	(そのとき、たくさんのひとがきゅうじょかつどうにさんかしていました。)<br>At that time, many people were participating in rescue operations.<br>(Past Positive Polite of ある)<br>(W1)<br>	[soundfile]
そのイベントには予想以上の参加者がありませんでした。	(そのイベントにはよそういじょうのさんかしゃがありませんでした。)<br>There were fewer participants than expected at the event.<br>(Past Negative Polite of ある)<br>(W1)<br>	[soundfile]
昨日は忙しくて、会議には参加できなかった。	(きのうはいそがしくて、かいぎにはさんかできなかった。)<br>Yesterday I was busy, so I couldn't attend the meeting.<br>(-te Form of ある)<br>(W1)<br>	[soundfile]
新しいアイデアが浮かんできた。これを試してみよう。	(あたらしいあいであがうかんできた。これをためしてみよう。)<br>A new idea has come up. Let's try this.<br>(Volitional of ある)<br>(W1)<br>	[soundfile]
その考え方は実現可能性がある。	(そのかんがえかたはじつげんかのうせいがある。)<br>That approach is feasible.<br>(Potential of ある)<br>(W1)<br>	[soundfile]
多くの意見が考慮されるべきだ。	(おおくのいけんがこうりょされるべきだ。)<br>Many opinions should be taken into consideration.<br>(Passive of ある)<br>(W1)<br>	[soundfile]
その問題は彼の怒りを引き起こさせた。	(そのもんだいはかれのいかりをひきおこさせた。)<br>The issue caused his anger.<br>(Causative of ある)<br>(W1)<br>	[soundfile]
そこに座れ。	(そこにすわれ。)<br>Sit there.<br>(Imperative of ある)<br>(W1)<br>	[soundfile]
もし時間があれば、映画に行きたい。	(もしじかんがあれば、えいがにいきたい。)<br>If there is time, I want to go to the movies.<br>(Conditional of ある)<br>(W1)<br>	[soundfile]