						
Present Positive Plain<br>買う	買う<br>(C1)
Present Negative Plain<br>買う	買わない<br>(C1)
Present Positive Polite<br>買う	買います<br>(C1)
Present Negative Polite<br>買う	買いません<br>(C1)
Past Positive Plain<br>買う	買った<br>(C1)
Past Negative Plain<br>買う	買わなかった<br>(C1)
Past Positive Polite<br>買う	買いました<br>(C1)
Past Negative Polite<br>買う	買いませんでした<br>(C1)
-te Form<br>買う	買って<br>(C1)
Volitional<br>買う	買おう<br>(C1)
Potential<br>買う	買える<br>(C1)
Passive<br>買う	買われる<br>(C1)
Causative<br>買う	買わせる<br>(C1)
Imperative<br>買う	買え<br>(C1)
Conditional<br>買う	買えば<br>(C1)
Present Positive Plain<br>思う	思う<br>(C2)
Present Negative Plain<br>思う	思わない<br>(C2)
Present Positive Polite<br>思う	思います<br>(C2)
Present Negative Polite<br>思う	思いません<br>(C2)
Past Positive Plain<br>思う	思った<br>(C2)
Past Negative Plain<br>思う	思わなかった<br>(C2)
Past Positive Polite<br>思う	思いました<br>(C2)
Past Negative Polite<br>思う	思いませんでした<br>(C2)
-te Form<br>思う	思って<br>(C2)
Volitional<br>思う	思おう<br>(C2)
Potential<br>思う	思える<br>(C2)
Passive<br>思う	思われる<br>(C2)
Causative<br>思う	思わせる<br>(C2)
Imperative<br>思う	思え<br>(C2)
Conditional<br>思う	思えば<br>(C2)
Present Positive Plain<br>言う	言う<br>(C3)
Present Negative Plain<br>言う	言わない<br>(C3)
Present Positive Polite<br>言う	言います<br>(C3)
Present Negative Polite<br>言う	言いません<br>(C3)
Past Positive Plain<br>言う	言った<br>(C3)
Past Negative Plain<br>言う	言わなかった<br>(C3)
Past Positive Polite<br>言う	言いました<br>(C3)
Past Negative Polite<br>言う	言いませんでした<br>(C3)
-te Form<br>言う	言って<br>(C3)
Volitional<br>言う	言おう<br>(C3)
Potential<br>言う	言える<br>(C3)
Passive<br>言う	言われる<br>(C3)
Causative<br>言う	言わせる<br>(C3)
Imperative<br>言う	言え<br>(C3)
Conditional<br>言う	言えば<br>(C3)
Present Positive Plain<br>飲む	飲む<br>(A1)
Present Negative Plain<br>飲む	飲まない<br>(A1)
Present Positive Polite<br>飲む	飲みます<br>(A1)
Present Negative Polite<br>飲む	飲みません<br>(A1)
Past Positive Plain<br>飲む	飲んだ<br>(A1)
Past Negative Plain<br>飲む	飲まなかった<br>(A1)
Past Positive Polite<br>飲む	飲みました<br>(A1)
Past Negative Polite<br>飲む	飲みませんでした<br>(A1)
-te Form<br>飲む	飲んで<br>(A1)
Volitional<br>飲む	飲もう<br>(A1)
Potential<br>飲む	飲める<br>(A1)
Passive<br>飲む	飲まれる<br>(A1)
Causative<br>飲む	飲ませる<br>(A1)
Imperative<br>飲む	飲め<br>(A1)
Conditional<br>飲む	飲めば<br>(A1)
Present Positive Plain<br>含む	含む<br>(A2)
Present Negative Plain<br>含む	含まない<br>(A2)
Present Positive Polite<br>含む	含みます<br>(A2)
Present Negative Polite<br>含む	含みません<br>(A2)
Past Positive Plain<br>含む	含んだ<br>(A2)
Past Negative Plain<br>含む	含まなかった<br>(A2)
Past Positive Polite<br>含む	含みました<br>(A2)
Past Negative Polite<br>含む	含みませんでした<br>(A2)
-te Form<br>含む	含んで<br>(A2)
Volitional<br>含む	含もう<br>(A2)
Potential<br>含む	含める<br>(A2)
Passive<br>含む	含まれる<br>(A2)
Causative<br>含む	含ませる<br>(A2)
Imperative<br>含む	含め<br>(A2)
Conditional<br>含む	含めば<br>(A2)
Present Positive Plain<br>住む	住む<br>(A3)
Present Negative Plain<br>住む	住まない<br>(A3)
Present Positive Polite<br>住む	住みます<br>(A3)
Present Negative Polite<br>住む	住みません<br>(A3)
Past Positive Plain<br>住む	住んだ<br>(A3)
Past Negative Plain<br>住む	住まなかった<br>(A3)
Past Positive Polite<br>住む	住みました<br>(A3)
Past Negative Polite<br>住む	住みませんでした<br>(A3)
-te Form<br>住む	住んで<br>(A3)
Volitional<br>住む	住もう<br>(A3)
Potential<br>住む	住める<br>(A3)
Passive<br>住む	住まれる<br>(A3)
Causative<br>住む	住ませる<br>(A3)
Imperative<br>住む	住め<br>(A3)
Conditional<br>住む	住めば<br>(A3)
Present Positive Plain<br>食べる	食べる<br>(B1)
Present Negative Plain<br>食べる	食べない<br>(B1)
Present Positive Polite<br>食べる	食べます<br>(B1)
Present Negative Polite<br>食べる	食べません<br>(B1)
Past Positive Plain<br>食べる	食べた<br>(B1)
Past Negative Plain<br>食べる	食べなかった<br>(B1)
Past Positive Polite<br>食べる	食べました<br>(B1)
Past Negative Polite<br>食べる	食べませんでした<br>(B1)
-te Form<br>食べる	食べて<br>(B1)
Volitional<br>食べる	食べよう<br>(B1)
Potential<br>食べる	食べられる<br>(B1)
Passive<br>食べる	食べられる<br>(B1)
Causative<br>食べる	食べさせる<br>(B1)
Imperative<br>食べる	食べろ<br>(B1)
Conditional<br>食べる	食べれば<br>(B1)
Present Positive Plain<br>見る	見る<br>(B2)
Present Negative Plain<br>見る	見ない<br>(B2)
Present Positive Polite<br>見る	見ます<br>(B2)
Present Negative Polite<br>見る	見ません<br>(B2)
Past Positive Plain<br>見る	見た<br>(B2)
Past Negative Plain<br>見る	見なかった<br>(B2)
Past Positive Polite<br>見る	見ました<br>(B2)
Past Negative Polite<br>見る	見ませんでした<br>(B2)
-te Form<br>見る	見て<br>(B2)
Volitional<br>見る	見よう<br>(B2)
Potential<br>見る	見られる<br>(B2)
Passive<br>見る	見られる<br>(B2)
Causative<br>見る	見させる<br>(B2)
Imperative<br>見る	見ろ<br>(B2)
Conditional<br>見る	見れば<br>(B2)
Present Positive Plain<br>用いる	用いる<br>(B3)
Present Negative Plain<br>用いる	用いない<br>(B3)
Present Positive Polite<br>用いる	用います<br>(B3)
Present Negative Polite<br>用いる	用いません<br>(B3)
Past Positive Plain<br>用いる	用いた<br>(B3)
Past Negative Plain<br>用いる	用いなかった<br>(B3)
Past Positive Polite<br>用いる	用いました<br>(B3)
Past Negative Polite<br>用いる	用いませんでした<br>(B3)
-te Form<br>用いる	用いて<br>(B3)
Volitional<br>用いる	用おう<br>(B3)
Potential<br>用いる	用える<br>(B3)
Passive<br>用いる	用われる<br>(B3)
Causative<br>用いる	用わせる<br>(B3)
Imperative<br>用いる	用いろ<br>(B3)
Conditional<br>用いる	用えば<br>(B3)
行く(D1)	行く	彼は毎朝ジョギングに行く。	(かれはまいあさじょぎんぐにいく。)	He goes jogging every morning.		Present Positive Plain
行く(D1)	行かない	彼女は雨の日には外出しない。	(かのじょはあめのひにはがいしゅつしない。)	She doesn't go out on rainy days.		Present Negative Plain
行く(D1)	行きます	私たちは今晩映画を見に行きます。	(わたしたちはこんばんえいがをみにいきます。)	We are going to see a movie tonight.		Present Positive Polite
行く(D1)	行きません	この週末は旅行には行きません。	(このしゅうまつはりょこうにはいきません。)	I'm not going on a trip this weekend.		Present Negative Polite
行く(D1)	行った	先週、友達と海へ行った。	(せんしゅう、ともだちとうみへいった。)	I went to the beach with my friends last week.		Past Positive Plain
行く(D1)	行かなかった	彼は昨日、授業に行かなかった。	(かれはきのう、じゅぎょうにいかなかった。)	He didn't go to class yesterday.		Past Negative Plain
行く(D1)	行きました	彼女は昨夜、コンサートに行きました。	(かのじょはさくや、こんさーとにいきました。)	She went to the concert last night.		Past Positive Polite
行く(D1)	行きませんでした	私たちは先週末、野外コンサートに行きませんでした。	(わたしたちはせんしゅうまつ、やがいこんさーとにいきませんでした。)	We didn't go to the outdoor concert last weekend.		Past Negative Polite
行く(D1)	行って	彼らは映画館に行ってきた。	(かれらはえいがかんにいってきた。)	They went to the movie theater.		-te Form
行く(D1)	行こう	明日は公園にピクニックしに行こう。	(あしたはこうえんにぴくにっくしにいこう。)	Let's go to the park for a picnic tomorrow.		Volitional
行く(D1)	行ける	彼は一人で外国に行ける。	(かれはひとりでがいこくにいける。)	He can go abroad alone.		Potential
行く(D1)	行かれる	その会社では、定期的に海外出張が行かれる。	(そのかいしゃでは、ていきてきにかいがいしゅっちょうがいかれる。)	In that company, regular overseas business trips are made.		Passive
行く(D1)	行かせる	両親は子供たちを映画館に行かせた。	(りょうしんはこどもたちをえいがかんにいかせた。)	The parents made the children go to the movie theater.		Causative
行く(D1)	行け	早く行け！	(はやくいけ！)	Go quickly!		Imperative
行く(D1)	行けば	もし天気が良ければ、散歩に行けばどうですか？	(もしてんきがよければ、さんぽにいけばどうですか？)	If the weather is good, how about going for a walk?		Conditional
往く(D2)	往く	彼は毎年夏に祖国へ往く。	(かれはまいとしなつにそこくへゆく。)	He goes back to his homeland every summer.		Present Positive Plain
往く(D2)	往かない	彼女は町から出ずに往かない。	(かのじょはまちからいずにいかない。)	She doesn't venture out of town.		Present Negative Plain
往く(D2)	往きます	彼は出張のために東京へ往きます。	(かれはしゅっちょうのためにとうきょうへいきます。)	He travels to Tokyo for business.		Present Positive Polite
往く(D2)	往きません	今日は用事があって出かけないので、外には往きません。	(きょうはようじがあってでかけないので、そとにはいきません。)	I won't go outside today because I have errands to run.		Present Negative Polite
往く(D2)	往いた	私は昨日、彼の家へ往いた。	(わたしはきのう、かれのいえへゆいた。)	I went to his house yesterday.		Past Positive Plain
往く(D2)	往かなかった	彼は昨日、予定が変わって出かけなかったので、祭りへ往かなかった。	(かれはきのう、よていがかわってでかけなかったので、まつりへいかなかった。)	He didn't go to the festival yesterday because his plans changed and he didn't go out.		Past Negative Plain
往く(D2)	往きました	先月、京都へ往きました。	(せんげつ、きょうとへいきました。)	I went to Kyoto last month.		Past Positive Polite
往く(D2)	往きませんでした	その日は雨だったので、公園へ往きませんでした。	(そのひはあめだったので、こうえんへいきませんでした。)	It was raining that day, so I didn't go to the park.		Past Negative Polite
往く(D2)	往いて	神社へお参りに往いて、お守りを買いました。	(じんじゃへおまいりにゆいて、おまもりをかいました。)	I went to the shrine to pray and bought a protective charm.		-te Form
往く(D2)	往こう	明日は山へ往こうと思っています。	(あしたはやまへいこうとおもっています。)	I'm thinking of going to the mountains tomorrow.		Volitional
往く(D2)	往ける	彼は自由に世界中を往ける。	(かれはじゆうにせかいじゅうをゆける。)	He can travel freely around the world.		Potential
往く(D2)	往かれる	その地域は多くの観光客によって訪れられている。	(そのちいきはおおくのかんこうきゃくによっておとずれられている。)	That area is visited by many tourists.		Passive
往く(D2)	往かせる	彼は子供たちを危険な場所へは往かせない。	(かれはこどもたちをきけんなばしょへはいかせない。)	He doesn't let the children go to dangerous places.		Causative
往く(D2)	往け	旅立ちの時が来たら、新しい冒険に往け！	(たびだちのときがきたら、あたらしいぼうけんにいけ！)	When the time for departure comes, go on a new adventure!		Imperative
往く(D2)	往けば	大学が近くにあれば、自転車で往けばいいですね。	(だいがくがちかくにあれば、じてんしゃでいけばいいですね。)	If the university is nearby, it would be good to go by bike.		Conditional
Present Positive Plain<br>イく	イく<br>(D3)
Present Negative Plain<br>イく	イかん<br>(D3)
Present Positive Polite<br>イく	イきます<br>(D3)
Present Negative Polite<br>イく	イきません<br>(D3)
Past Positive Plain<br>イく	イった<br>(D3)
Past Negative Plain<br>イく	イかんかった<br>(D3)
Past Positive Polite<br>イく	イきました<br>(D3)
Past Negative Polite<br>イく	イきませんでした<br>(D3)
-te Form<br>イく	イって<br>(D3)
Volitional<br>イく	イこう<br>(D3)
Potential<br>イく	イける<br>(D3)
Passive<br>イく	イかれる<br>(D3)
Causative<br>イく	イかせる<br>(D3)
Imperative<br>イく	イけ<br>(D3)
Conditional<br>イく	イけば<br>(D3)
Present Positive Plain<br>禁ずる	禁ずる<br>(E1)
Present Negative Plain<br>禁ずる	禁ずられない<br>(E1)
Present Positive Polite<br>禁ずる	禁ずります<br>(E1)
Present Negative Polite<br>禁ずる	禁ずりません<br>(E1)
Past Positive Plain<br>禁ずる	禁ずった<br>(E1)
Past Negative Plain<br>禁ずる	禁ずられなかった<br>(E1)
Past Positive Polite<br>禁ずる	禁ずりました<br>(E1)
Past Negative Polite<br>禁ずる	禁ずりませんでした<br>(E1)
-te Form<br>禁ずる	禁ずって<br>(E1)
Volitional<br>禁ずる	禁ずろう<br>(E1)
Potential<br>禁ずる	禁ずれる<br>(E1)
Passive<br>禁ずる	禁ずられる<br>(E1)
Causative<br>禁ずる	禁ずらせる<br>(E1)
Imperative<br>禁ずる	禁ずれ<br>(E1)
Conditional<br>禁ずる	禁ずれば<br>(E1)
Present Positive Plain<br>信ずる	信ずる<br>(E2)
Present Negative Plain<br>信ずる	信じない<br>(E2)
Present Positive Polite<br>信ずる	信じます<br>(E2)
Present Negative Polite<br>信ずる	信じません<br>(E2)
Past Positive Plain<br>信ずる	信じた<br>(E2)
Past Negative Plain<br>信ずる	信じなかった<br>(E2)
Past Positive Polite<br>信ずる	信じました<br>(E2)
Past Negative Polite<br>信ずる	信じませんでした<br>(E2)
-te Form<br>信ずる	信じて<br>(E2)
Volitional<br>信ずる	信じよう<br>(E2)
Potential<br>信ずる	信じられる<br>(E2)
Passive<br>信ずる	信じられる<br>(E2)
Causative<br>信ずる	信じさせる<br>(E2)
Imperative<br>信ずる	信じろ<br>(E2)
Conditional<br>信ずる	信じれば<br>(E2)
Present Positive Plain<br>命ずる	命ずる<br>(E3)
Present Negative Plain<br>命ずる	命ずらない<br>(E3)
Present Positive Polite<br>命ずる	命ずります<br>(E3)
Present Negative Polite<br>命ずる	命ずりません<br>(E3)
Past Positive Plain<br>命ずる	命ずった<br>(E3)
Past Negative Plain<br>命ずる	命ずらなかった<br>(E3)
Past Positive Polite<br>命ずる	命ずりました<br>(E3)
Past Negative Polite<br>命ずる	命ずりませんでした<br>(E3)
-te Form<br>命ずる	命ずって<br>(E3)
Volitional<br>命ずる	命ずろう<br>(E3)
Potential<br>命ずる	命ずれる<br>(E3)
Passive<br>命ずる	命ずられる<br>(E3)
Causative<br>命ずる	命ずらせる<br>(E3)
Imperative<br>命ずる	命ずれ<br>(E3)
Conditional<br>命ずる	命ずれば<br>(E3)
Present Positive Plain<br>泳ぐ	泳ぐ<br>(F1)
Present Negative Plain<br>泳ぐ	泳がない<br>(F1)
Present Positive Polite<br>泳ぐ	泳ぎます<br>(F1)
Present Negative Polite<br>泳ぐ	泳ぎません<br>(F1)
Past Positive Plain<br>泳ぐ	泳いだ<br>(F1)
Past Negative Plain<br>泳ぐ	泳がなかった<br>(F1)
Past Positive Polite<br>泳ぐ	泳ぎました<br>(F1)
Past Negative Polite<br>泳ぐ	泳ぎませんでした<br>(F1)
-te Form<br>泳ぐ	泳いで<br>(F1)
Volitional<br>泳ぐ	泳ごう<br>(F1)
Potential<br>泳ぐ	泳げる<br>(F1)
Passive<br>泳ぐ	泳がれる<br>(F1)
Causative<br>泳ぐ	泳がせる<br>(F1)
Imperative<br>泳ぐ	泳げ<br>(F1)
Conditional<br>泳ぐ	泳げば<br>(F1)
Present Positive Plain<br>次ぐ	次ぐ<br>(F2)
Present Negative Plain<br>次ぐ	次がない<br>(F2)
Present Positive Polite<br>次ぐ	次ぎます<br>(F2)
Present Negative Polite<br>次ぐ	次ぎません<br>(F2)
Past Positive Plain<br>次ぐ	次いだ<br>(F2)
Past Negative Plain<br>次ぐ	次がなかった<br>(F2)
Past Positive Polite<br>次ぐ	次ぎました<br>(F2)
Past Negative Polite<br>次ぐ	次ぎませんでした<br>(F2)
-te Form<br>次ぐ	次いで<br>(F2)
Volitional<br>次ぐ	次ごう<br>(F2)
Potential<br>次ぐ	次げる<br>(F2)
Passive<br>次ぐ	次がれる<br>(F2)
Causative<br>次ぐ	次がせる<br>(F2)
Imperative<br>次ぐ	次げ<br>(F2)
Conditional<br>次ぐ	次げば<br>(F2)
Present Positive Plain<br>注ぐ	注ぐ<br>(F3)
Present Negative Plain<br>注ぐ	注がない<br>(F3)
Present Positive Polite<br>注ぐ	注ぎます<br>(F3)
Present Negative Polite<br>注ぐ	注ぎません<br>(F3)
Past Positive Plain<br>注ぐ	注いだ<br>(F3)
Past Negative Plain<br>注ぐ	注がなかった<br>(F3)
Past Positive Polite<br>注ぐ	注ぎました<br>(F3)
Past Negative Polite<br>注ぐ	注ぎませんでした<br>(F3)
-te Form<br>注ぐ	注いで<br>(F3)
Volitional<br>注ぐ	注ごう<br>(F3)
Potential<br>注ぐ	注げる<br>(F3)
Passive<br>注ぐ	注がれる<br>(F3)
Causative<br>注ぐ	注がせる<br>(F3)
Imperative<br>注ぐ	注げ<br>(F3)
Conditional<br>注ぐ	注げば<br>(F3)
Present Positive Plain<br>死ぬ	死ぬ<br>(G1)
Present Negative Plain<br>死ぬ	死なない<br>(G1)
Present Positive Polite<br>死ぬ	死にます<br>(G1)
Present Negative Polite<br>死ぬ	死にません<br>(G1)
Past Positive Plain<br>死ぬ	死んだ<br>(G1)
Past Negative Plain<br>死ぬ	死ななかった<br>(G1)
Past Positive Polite<br>死ぬ	死にました<br>(G1)
Past Negative Polite<br>死ぬ	死にませんでした<br>(G1)
-te Form<br>死ぬ	死んで<br>(G1)
Volitional<br>死ぬ	死のう<br>(G1)
Potential<br>死ぬ	死ねる<br>(G1)
Passive<br>死ぬ	死なれる<br>(G1)
Causative<br>死ぬ	死なせる<br>(G1)
Imperative<br>死ぬ	死ね<br>(G1)
Conditional<br>死ぬ	死ねば<br>(G1)
Present Positive Plain<br>去ぬ	去ぬ<br>(G2)
Present Negative Plain<br>去ぬ	去らない<br>(G2)
Present Positive Polite<br>去ぬ	去ります<br>(G2)
Present Negative Polite<br>去ぬ	去りません<br>(G2)
Past Positive Plain<br>去ぬ	去った<br>(G2)
Past Negative Plain<br>去ぬ	去らなかった<br>(G2)
Past Positive Polite<br>去ぬ	去りました<br>(G2)
Past Negative Polite<br>去ぬ	去りませんでした<br>(G2)
-te Form<br>去ぬ	去って<br>(G2)
Volitional<br>去ぬ	去ろう<br>(G2)
Potential<br>去ぬ	去れる<br>(G2)
Passive<br>去ぬ	去られる<br>(G2)
Causative<br>去ぬ	去らせる<br>(G2)
Imperative<br>去ぬ	去れ<br>(G2)
Conditional<br>去ぬ	去れば<br>(G2)
Present Positive Plain<br>往ぬ	往ぬ<br>(G3)
Present Negative Plain<br>往ぬ	往かぬ<br>(G3)
Present Positive Polite<br>往ぬ	往きます<br>(G3)
Present Negative Polite<br>往ぬ	往きません<br>(G3)
Past Positive Plain<br>往ぬ	往った<br>(G3)
Past Negative Plain<br>往ぬ	往かなかった<br>(G3)
Past Positive Polite<br>往ぬ	往きました<br>(G3)
Past Negative Polite<br>往ぬ	往きませんでした<br>(G3)
-te Form<br>往ぬ	往いて<br>(G3)
Volitional<br>往ぬ	往こう<br>(G3)
Potential<br>往ぬ	往ける<br>(G3)
Passive<br>往ぬ	往かれる<br>(G3)
Causative<br>往ぬ	往かせる<br>(G3)
Imperative<br>往ぬ	往け<br>(G3)
Conditional<br>往ぬ	往けば<br>(G3)
Present Positive Plain<br>来る	来る<br>(H1)
Present Negative Plain<br>来る	来ない<br>(H1)
Present Positive Polite<br>来る	来ます<br>(H1)
Present Negative Polite<br>来る	来ません<br>(H1)
Past Positive Plain<br>来る	来た<br>(H1)
Past Negative Plain<br>来る	来なかった<br>(H1)
Past Positive Polite<br>来る	来ました<br>(H1)
Past Negative Polite<br>来る	来ませんでした<br>(H1)
-te Form<br>来る	来て<br>(H1)
Volitional<br>来る	来よう<br>(H1)
Potential<br>来る	来られる<br>(H1)
Passive<br>来る	来られる<br>(H1)
Causative<br>来る	来させる<br>(H1)
Imperative<br>来る	来い<br>(H1)
Conditional<br>来る	来れば<br>(H1)
Present Positive Plain<br>連れて来る	連れて来る<br>(H2)
Present Negative Plain<br>連れて来る	連れて来ない<br>(H2)
Present Positive Polite<br>連れて来る	連れて来ます<br>(H2)
Present Negative Polite<br>連れて来る	連れて来ません<br>(H2)
Past Positive Plain<br>連れて来る	連れて来た<br>(H2)
Past Negative Plain<br>連れて来る	連れて来なかった<br>(H2)
Past Positive Polite<br>連れて来る	連れて来ました<br>(H2)
Past Negative Polite<br>連れて来る	連れて来ませんでした<br>(H2)
-te Form<br>連れて来る	連れて来て<br>(H2)
Volitional<br>連れて来る	連れて来よう<br>(H2)
Potential<br>連れて来る	連れて来られる<br>(H2)
Passive<br>連れて来る	連れて来られる<br>(H2)
Causative<br>連れて来る	連れて来させる<br>(H2)
Imperative<br>連れて来る	連れて来い<br>(H2)
Conditional<br>連れて来る	連れて来れば<br>(H2)
Present Positive Plain<br>有る	有る<br>(I1)
Present Negative Plain<br>有る	有らない<br>(I1)
Present Positive Polite<br>有る	有ります<br>(I1)
Present Negative Polite<br>有る	有りません<br>(I1)
Past Positive Plain<br>有る	有った<br>(I1)
Past Negative Plain<br>有る	有らなかった<br>(I1)
Past Positive Polite<br>有る	有りました<br>(I1)
Past Negative Polite<br>有る	有りませんでした<br>(I1)
-te Form<br>有る	有って<br>(I1)
Volitional<br>有る	有ろう<br>(I1)
Potential<br>有る	有れる<br>(I1)
Passive<br>有る	有られる<br>(I1)
Causative<br>有る	有らせる<br>(I1)
Imperative<br>有る	有れ<br>(I1)
Conditional<br>有る	有れば<br>(I1)
Present Positive Plain<br>書く	書く<br>(J1)
Present Negative Plain<br>書く	書かない<br>(J1)
Present Positive Polite<br>書く	書きます<br>(J1)
Present Negative Polite<br>書く	書きません<br>(J1)
Past Positive Plain<br>書く	書いた<br>(J1)
Past Negative Plain<br>書く	書かなかった<br>(J1)
Past Positive Polite<br>書く	書きました<br>(J1)
Past Negative Polite<br>書く	書きませんでした<br>(J1)
-te Form<br>書く	書いて<br>(J1)
Volitional<br>書く	書こう<br>(J1)
Potential<br>書く	書ける<br>(J1)
Passive<br>書く	書かれる<br>(J1)
Causative<br>書く	書かせる<br>(J1)
Imperative<br>書く	書け<br>(J1)
Conditional<br>書く	書けば<br>(J1)
Present Positive Plain<br>聞く	聞く<br>(J2)
Present Negative Plain<br>聞く	聞かない<br>(J2)
Present Positive Polite<br>聞く	聞きます<br>(J2)
Present Negative Polite<br>聞く	聞きません<br>(J2)
Past Positive Plain<br>聞く	聞いた<br>(J2)
Past Negative Plain<br>聞く	聞かなかった<br>(J2)
Past Positive Polite<br>聞く	聞きました<br>(J2)
Past Negative Polite<br>聞く	聞きませんでした<br>(J2)
-te Form<br>聞く	聞いて<br>(J2)
Volitional<br>聞く	聞こう<br>(J2)
Potential<br>聞く	聞ける<br>(J2)
Passive<br>聞く	聞かれる<br>(J2)
Causative<br>聞く	聞かせる<br>(J2)
Imperative<br>聞く	聞け<br>(J2)
Conditional<br>聞く	聞けば<br>(J2)
Present Positive Plain<br>置く	置く<br>(J3)
Present Negative Plain<br>置く	置かない<br>(J3)
Present Positive Polite<br>置く	置きます<br>(J3)
Present Negative Polite<br>置く	置きません<br>(J3)
Past Positive Plain<br>置く	置いた<br>(J3)
Past Negative Plain<br>置く	置かなかった<br>(J3)
Past Positive Polite<br>置く	置きました<br>(J3)
Past Negative Polite<br>置く	置きませんでした<br>(J3)
-te Form<br>置く	置いて<br>(J3)
Volitional<br>置く	置こう<br>(J3)
Potential<br>置く	置ける<br>(J3)
Passive<br>置く	置かれる<br>(J3)
Causative<br>置く	置かせる<br>(J3)
Imperative<br>置く	置け<br>(J3)
Conditional<br>置く	置けば<br>(J3)
Present Positive Plain<br>接する	接する<br>(K1)
Present Negative Plain<br>接する	接しない<br>(K1)
Present Positive Polite<br>接する	接します<br>(K1)
Present Negative Polite<br>接する	接しません<br>(K1)
Past Positive Plain<br>接する	接した<br>(K1)
Past Negative Plain<br>接する	接しなかった<br>(K1)
Past Positive Polite<br>接する	接しました<br>(K1)
Past Negative Polite<br>接する	接しませんでした<br>(K1)
-te Form<br>接する	接して<br>(K1)
Volitional<br>接する	接しよう<br>(K1)
Potential<br>接する	接できる<br>(K1)
Passive<br>接する	接される<br>(K1)
Causative<br>接する	接させる<br>(K1)
Imperative<br>接する	接せよ<br>(K1)
Conditional<br>接する	接すれば<br>(K1)
Present Positive Plain<br>発する	発する<br>(K2)
Present Negative Plain<br>発する	発しない<br>(K2)
Present Positive Polite<br>発する	発します<br>(K2)
Present Negative Polite<br>発する	発しません<br>(K2)
Past Positive Plain<br>発する	発した<br>(K2)
Past Negative Plain<br>発する	発さなかった<br>(K2)
Past Positive Polite<br>発する	発しました<br>(K2)
Past Negative Polite<br>発する	発しませんでした<br>(K2)
-te Form<br>発する	発して<br>(K2)
Volitional<br>発する	発そう<br>(K2)
Potential<br>発する	発できる<br>(K2)
Passive<br>発する	発される<br>(K2)
Causative<br>発する	発させる<br>(K2)
Imperative<br>発する	発せよ<br>(K2)
Conditional<br>発する	発すれば<br>(K2)
Present Positive Plain<br>罰する	罰する<br>(K3)
Present Negative Plain<br>罰する	罰しない<br>(K3)
Present Positive Polite<br>罰する	罰します<br>(K3)
Present Negative Polite<br>罰する	罰しません<br>(K3)
Past Positive Plain<br>罰する	罰した<br>(K3)
Past Negative Plain<br>罰する	罰さなかった<br>(K3)
Past Positive Polite<br>罰する	罰しました<br>(K3)
Past Negative Polite<br>罰する	罰しませんでした<br>(K3)
-te Form<br>罰する	罰して<br>(K3)
Volitional<br>罰する	罰そう<br>(K3)
Potential<br>罰する	罰できる<br>(K3)
Passive<br>罰する	罰される<br>(K3)
Causative<br>罰する	罰させる<br>(K3)
Imperative<br>罰する	罰せよ<br>(K3)
Conditional<br>罰する	罰すれば<br>(K3)
Present Positive Plain<br>指す	指す<br>(L1)
Present Negative Plain<br>指す	指さない<br>(L1)
Present Positive Polite<br>指す	指します<br>(L1)
Present Negative Polite<br>指す	指しません<br>(L1)
Past Positive Plain<br>指す	指した<br>(L1)
Past Negative Plain<br>指す	指さなかった<br>(L1)
Past Positive Polite<br>指す	指しました<br>(L1)
Past Negative Polite<br>指す	指しませんでした<br>(L1)
-te Form<br>指す	指して<br>(L1)
Volitional<br>指す	指そう<br>(L1)
Potential<br>指す	指せる<br>(L1)
Passive<br>指す	指される<br>(L1)
Causative<br>指す	指させる<br>(L1)
Imperative<br>指す	指せ<br>(L1)
Conditional<br>指す	指せば<br>(L1)
Present Positive Plain<br>話す	話す<br>(L2)
Present Negative Plain<br>話す	話さない<br>(L2)
Present Positive Polite<br>話す	話します<br>(L2)
Present Negative Polite<br>話す	話しません<br>(L2)
Past Positive Plain<br>話す	話した<br>(L2)
Past Negative Plain<br>話す	話さなかった<br>(L2)
Past Positive Polite<br>話す	話しました<br>(L2)
Past Negative Polite<br>話す	話しませんでした<br>(L2)
-te Form<br>話す	話して<br>(L2)
Volitional<br>話す	話そう<br>(L2)
Potential<br>話す	話せる<br>(L2)
Passive<br>話す	話される<br>(L2)
Causative<br>話す	話させる<br>(L2)
Imperative<br>話す	話せ<br>(L2)
Conditional<br>話す	話せば<br>(L2)
Present Positive Plain<br>示す	示す<br>(L3)
Present Negative Plain<br>示す	示さない<br>(L3)
Present Positive Polite<br>示す	示します<br>(L3)
Present Negative Polite<br>示す	示しません<br>(L3)
Past Positive Plain<br>示す	示した<br>(L3)
Past Negative Plain<br>示す	示さなかった<br>(L3)
Past Positive Polite<br>示す	示しました<br>(L3)
Past Negative Polite<br>示す	示しませんでした<br>(L3)
-te Form<br>示す	示して<br>(L3)
Volitional<br>示す	示そう<br>(L3)
Potential<br>示す	示せる<br>(L3)
Passive<br>示す	示される<br>(L3)
Causative<br>示す	示させる<br>(L3)
Imperative<br>示す	示せ<br>(L3)
Conditional<br>示す	示せば<br>(L3)
Present Positive Plain<br>愛する	愛する<br>(M1)
Present Negative Plain<br>愛する	愛さない<br>(M1)
Present Positive Polite<br>愛する	愛します<br>(M1)
Present Negative Polite<br>愛する	愛しません<br>(M1)
Past Positive Plain<br>愛する	愛した<br>(M1)
Past Negative Plain<br>愛する	愛さなかった<br>(M1)
Past Positive Polite<br>愛する	愛しました<br>(M1)
Past Negative Polite<br>愛する	愛しませんでした<br>(M1)
-te Form<br>愛する	愛して<br>(M1)
Volitional<br>愛する	愛しよう<br>(M1)
Potential<br>愛する	愛せる<br>(M1)
Passive<br>愛する	愛される<br>(M1)
Causative<br>愛する	愛させる<br>(M1)
Imperative<br>愛する	愛せ<br>(M1)
Conditional<br>愛する	愛せば<br>(M1)
Present Positive Plain<br>化する	化する<br>(M2)
Present Negative Plain<br>化する	化しない<br>(M2)
Present Positive Polite<br>化する	化します<br>(M2)
Present Negative Polite<br>化する	化しません<br>(M2)
Past Positive Plain<br>化する	化した<br>(M2)
Past Negative Plain<br>化する	化さなかった<br>(M2)
Past Positive Polite<br>化する	化しました<br>(M2)
Past Negative Polite<br>化する	化しませんでした<br>(M2)
-te Form<br>化する	化して<br>(M2)
Volitional<br>化する	化そう<br>(M2)
Potential<br>化する	化せる<br>(M2)
Passive<br>化する	化される<br>(M2)
Causative<br>化する	化させる<br>(M2)
Imperative<br>化する	化せよ<br>(M2)
Conditional<br>化する	化せば<br>(M2)
Present Positive Plain<br>属する	属する<br>(M3)
Present Negative Plain<br>属する	属さない<br>(M3)
Present Positive Polite<br>属する	属します<br>(M3)
Present Negative Polite<br>属する	属しません<br>(M3)
Past Positive Plain<br>属する	属した<br>(M3)
Past Negative Plain<br>属する	属さなかった<br>(M3)
Past Positive Polite<br>属する	属しました<br>(M3)
Past Negative Polite<br>属する	属しませんでした<br>(M3)
-te Form<br>属する	属して<br>(M3)
Volitional<br>属する	属しよう<br>(M3)
Potential<br>属する	属せる<br>(M3)
Passive<br>属する	属される<br>(M3)
Causative<br>属する	属させる<br>(M3)
Imperative<br>属する	属せ<br>(M3)
Conditional<br>属する	属せば<br>(M3)
Present Positive Plain<br>待つ	待つ<br>(N1)
Present Negative Plain<br>待つ	待たない<br>(N1)
Present Positive Polite<br>待つ	待ちます<br>(N1)
Present Negative Polite<br>待つ	待ちません<br>(N1)
Past Positive Plain<br>待つ	待った<br>(N1)
Past Negative Plain<br>待つ	待たなかった<br>(N1)
Past Positive Polite<br>待つ	待ちました<br>(N1)
Past Negative Polite<br>待つ	待ちませんでした<br>(N1)
-te Form<br>待つ	待って<br>(N1)
Volitional<br>待つ	待とう<br>(N1)
Potential<br>待つ	待てる<br>(N1)
Passive<br>待つ	待たれる<br>(N1)
Causative<br>待つ	待たせる<br>(N1)
Imperative<br>待つ	待て<br>(N1)
Conditional<br>待つ	待てば<br>(N1)
Present Positive Plain<br>持つ	持つ<br>(N2)
Present Negative Plain<br>持つ	持たない<br>(N2)
Present Positive Polite<br>持つ	持ちます<br>(N2)
Present Negative Polite<br>持つ	持ちません<br>(N2)
Past Positive Plain<br>持つ	持った<br>(N2)
Past Negative Plain<br>持つ	持たなかった<br>(N2)
Past Positive Polite<br>持つ	持ちました<br>(N2)
Past Negative Polite<br>持つ	持ちませんでした<br>(N2)
-te Form<br>持つ	持って<br>(N2)
Volitional<br>持つ	持とう<br>(N2)
Potential<br>持つ	持てる<br>(N2)
Passive<br>持つ	持たれる<br>(N2)
Causative<br>持つ	持たせる<br>(N2)
Imperative<br>持つ	持て<br>(N2)
Conditional<br>持つ	持てば<br>(N2)
Present Positive Plain<br>立つ	立つ<br>(N3)
Present Negative Plain<br>立つ	立たない<br>(N3)
Present Positive Polite<br>立つ	立ちます<br>(N3)
Present Negative Polite<br>立つ	立ちません<br>(N3)
Past Positive Plain<br>立つ	立った<br>(N3)
Past Negative Plain<br>立つ	立たなかった<br>(N3)
Past Positive Polite<br>立つ	立ちました<br>(N3)
Past Negative Polite<br>立つ	立ちませんでした<br>(N3)
-te Form<br>立つ	立って<br>(N3)
Volitional<br>立つ	立とう<br>(N3)
Potential<br>立つ	立てる<br>(N3)
Passive<br>立つ	立たれる<br>(N3)
Causative<br>立つ	立たせる<br>(N3)
Imperative<br>立つ	立て<br>(N3)
Conditional<br>立つ	立てば<br>(N3)
Present Positive Plain<br>在る	在る<br>(O1)
Present Negative Plain<br>在る	在らない<br>(O1)
Present Positive Polite<br>在る	在ります<br>(O1)
Present Negative Polite<br>在る	在りません<br>(O1)
Past Positive Plain<br>在る	在った<br>(O1)
Past Negative Plain<br>在る	在らなかった<br>(O1)
Past Positive Polite<br>在る	在りました<br>(O1)
Past Negative Polite<br>在る	在りませんでした<br>(O1)
-te Form<br>在る	在って<br>(O1)
Volitional<br>在る	在ろう<br>(O1)
Potential<br>在る	在れる<br>(O1)
Passive<br>在る	在られる<br>(O1)
Causative<br>在る	在らせる<br>(O1)
Imperative<br>在る	在れ<br>(O1)
Conditional<br>在る	在れば<br>(O1)
Present Positive Plain<br>問う	問う<br>(P1)
Present Negative Plain<br>問う	問わない<br>(P1)
Present Positive Polite<br>問う	問います<br>(P1)
Present Negative Polite<br>問う	問いません<br>(P1)
Past Positive Plain<br>問う	問った<br>(P1)
Past Negative Plain<br>問う	問わなかった<br>(P1)
Past Positive Polite<br>問う	問いました<br>(P1)
Past Negative Polite<br>問う	問いませんでした<br>(P1)
-te Form<br>問う	問って<br>(P1)
Volitional<br>問う	問おう<br>(P1)
Potential<br>問う	問える<br>(P1)
Passive<br>問う	問われる<br>(P1)
Causative<br>問う	問わせる<br>(P1)
Imperative<br>問う	問え<br>(P1)
Conditional<br>問う	問えば<br>(P1)
Present Positive Plain<br>呼ぶ	呼ぶ<br>(Q1)
Present Negative Plain<br>呼ぶ	呼ばない<br>(Q1)
Present Positive Polite<br>呼ぶ	呼びます<br>(Q1)
Present Negative Polite<br>呼ぶ	呼びません<br>(Q1)
Past Positive Plain<br>呼ぶ	呼んだ<br>(Q1)
Past Negative Plain<br>呼ぶ	呼ばなかった<br>(Q1)
Past Positive Polite<br>呼ぶ	呼びました<br>(Q1)
Past Negative Polite<br>呼ぶ	呼びませんでした<br>(Q1)
-te Form<br>呼ぶ	呼んで<br>(Q1)
Volitional<br>呼ぶ	呼ぼう<br>(Q1)
Potential<br>呼ぶ	呼べる<br>(Q1)
Passive<br>呼ぶ	呼ばれる<br>(Q1)
Causative<br>呼ぶ	呼ばせる<br>(Q1)
Imperative<br>呼ぶ	呼べ<br>(Q1)
Conditional<br>呼ぶ	呼べば<br>(Q1)
Present Positive Plain<br>学ぶ	学ぶ<br>(Q2)
Present Negative Plain<br>学ぶ	学ばない<br>(Q2)
Present Positive Polite<br>学ぶ	学びます<br>(Q2)
Present Negative Polite<br>学ぶ	学びません<br>(Q2)
Past Positive Plain<br>学ぶ	学んだ<br>(Q2)
Past Negative Plain<br>学ぶ	学ばなかった<br>(Q2)
Past Positive Polite<br>学ぶ	学びました<br>(Q2)
Past Negative Polite<br>学ぶ	学びませんでした<br>(Q2)
-te Form<br>学ぶ	学んで<br>(Q2)
Volitional<br>学ぶ	学ぼう<br>(Q2)
Potential<br>学ぶ	学べる<br>(Q2)
Passive<br>学ぶ	学ばれる<br>(Q2)
Causative<br>学ぶ	学ばせる<br>(Q2)
Imperative<br>学ぶ	学べ<br>(Q2)
Conditional<br>学ぶ	学べば<br>(Q2)
Present Positive Plain<br>並ぶ	並ぶ<br>(Q3)
Present Negative Plain<br>並ぶ	並ばない<br>(Q3)
Present Positive Polite<br>並ぶ	並びます<br>(Q3)
Present Negative Polite<br>並ぶ	並びません<br>(Q3)
Past Positive Plain<br>並ぶ	並んだ<br>(Q3)
Past Negative Plain<br>並ぶ	並ばなかった<br>(Q3)
Past Positive Polite<br>並ぶ	並びました<br>(Q3)
Past Negative Polite<br>並ぶ	並びませんでした<br>(Q3)
-te Form<br>並ぶ	並んで<br>(Q3)
Volitional<br>並ぶ	並ぼう<br>(Q3)
Potential<br>並ぶ	並べる<br>(Q3)
Passive<br>並ぶ	並ばれる<br>(Q3)
Causative<br>並ぶ	並ばせる<br>(Q3)
Imperative<br>並ぶ	並べ<br>(Q3)
Conditional<br>並ぶ	並べば<br>(Q3)
Present Positive Plain<br>入る	入る<br>(R1)
Present Negative Plain<br>入る	入らない<br>(R1)
Present Positive Polite<br>入る	入ります<br>(R1)
Present Negative Polite<br>入る	入りません<br>(R1)
Past Positive Plain<br>入る	入った<br>(R1)
Past Negative Plain<br>入る	入らなかった<br>(R1)
Past Positive Polite<br>入る	入りました<br>(R1)
Past Negative Polite<br>入る	入りませんでした<br>(R1)
-te Form<br>入る	入って<br>(R1)
Volitional<br>入る	入ろう<br>(R1)
Potential<br>入る	入れる<br>(R1)
Passive<br>入る	入られる<br>(R1)
Causative<br>入る	入れさせる<br>(R1)
Imperative<br>入る	入れ<br>(R1)
Conditional<br>入る	入れば<br>(R1)
Present Positive Plain<br>作る	作る<br>(R2)
Present Negative Plain<br>作る	作らない<br>(R2)
Present Positive Polite<br>作る	作ります<br>(R2)
Present Negative Polite<br>作る	作りません<br>(R2)
Past Positive Plain<br>作る	作った<br>(R2)
Past Negative Plain<br>作る	作らなかった<br>(R2)
Past Positive Polite<br>作る	作りました<br>(R2)
Past Negative Polite<br>作る	作りませんでした<br>(R2)
-te Form<br>作る	作って<br>(R2)
Volitional<br>作る	作ろう<br>(R2)
Potential<br>作る	作れる<br>(R2)
Passive<br>作る	作られる<br>(R2)
Causative<br>作る	作らせる<br>(R2)
Imperative<br>作る	作れ<br>(R2)
Conditional<br>作る	作れば<br>(R2)
Present Positive Plain<br>知る	知る<br>(R3)
Present Negative Plain<br>知る	知らない<br>(R3)
Present Positive Polite<br>知る	知ります<br>(R3)
Present Negative Polite<br>知る	知りません<br>(R3)
Past Positive Plain<br>知る	知った<br>(R3)
Past Negative Plain<br>知る	知らなかった<br>(R3)
Past Positive Polite<br>知る	知りました<br>(R3)
Past Negative Polite<br>知る	知りませんでした<br>(R3)
-te Form<br>知る	知って<br>(R3)
Volitional<br>知る	知ろう<br>(R3)
Potential<br>知る	知れる<br>(R3)
Passive<br>知る	知られる<br>(R3)
Causative<br>知る	知らせる<br>(R3)
Imperative<br>知る	知れ<br>(R3)
Conditional<br>知る	知れば<br>(R3)
Present Positive Plain<br>分かる	分かる<br>(R4)
Present Negative Plain<br>分かる	分からない<br>(R4)
Present Positive Polite<br>分かる	分かります<br>(R4)
Present Negative Polite<br>分かる	分かりません<br>(R4)
Past Positive Plain<br>分かる	分かった<br>(R4)
Past Negative Plain<br>分かる	分からなかった<br>(R4)
Past Positive Polite<br>分かる	分かりました<br>(R4)
Past Negative Polite<br>分かる	分かりませんでした<br>(R4)
-te Form<br>分かる	分かって<br>(R4)
Volitional<br>分かる	分かろう<br>(R4)
Potential<br>分かる	分かれる<br>(R4)
Passive<br>分かる	分かれる<br>(R4)
Causative<br>分かる	分からせる<br>(R4)
Imperative<br>分かる	分かれ<br>(R4)
Conditional<br>分かる	分かれば<br>(R4)
Present Positive Plain<br>なさる	なさる<br>(S1)
Present Negative Plain<br>なさる	なさらない<br>(S1)
Present Positive Polite<br>なさる	なさいます<br>(S1)
Present Negative Polite<br>なさる	なさいません<br>(S1)
Past Positive Plain<br>なさる	なさった<br>(S1)
Past Negative Plain<br>なさる	なさらなかった<br>(S1)
Past Positive Polite<br>なさる	なさいました<br>(S1)
Past Negative Polite<br>なさる	なさいませんでした<br>(S1)
-te Form<br>なさる	なさって<br>(S1)
Volitional<br>なさる	なさろう<br>(S1)
Potential<br>なさる	なされる<br>(S1)
Passive<br>なさる	なさられる<br>(S1)
Causative<br>なさる	なさらせる<br>(S1)
Imperative<br>なさる	なさって<br>(S1)
Conditional<br>なさる	なされば<br>(S1)
Present Positive Plain<br>下さる	下さる<br>(S2)
Present Negative Plain<br>下さる	下さらない<br>(S2)
Present Positive Polite<br>下さる	下さいます<br>(S2)
Present Negative Polite<br>下さる	下さいません<br>(S2)
Past Positive Plain<br>下さる	下さった<br>(S2)
Past Negative Plain<br>下さる	下さらなかった<br>(S2)
Past Positive Polite<br>下さる	下さいました<br>(S2)
Past Negative Polite<br>下さる	下さいませんでした<br>(S2)
-te Form<br>下さる	下さって<br>(S2)
Volitional<br>下さる	下さろう<br>(S2)
Potential<br>下さる	下される<br>(S2)
Passive<br>下さる	下さられる<br>(S2)
Causative<br>下さる	下さらせる<br>(S2)
Imperative<br>下さる	下さい<br>(S2)
Conditional<br>下さる	下されば<br>(S2)
Present Positive Plain<br>仰る	仰る<br>(S3)
Present Negative Plain<br>仰る	仰らない<br>(S3)
Present Positive Polite<br>仰る	仰います<br>(S3)
Present Negative Polite<br>仰る	仰いません<br>(S3)
Past Positive Plain<br>仰る	仰った<br>(S3)
Past Negative Plain<br>仰る	仰らなかった<br>(S3)
Past Positive Polite<br>仰る	仰いました<br>(S3)
Past Negative Polite<br>仰る	仰いませんでした<br>(S3)
-te Form<br>仰る	仰って<br>(S3)
Volitional<br>仰る	仰りましょう<br>(S3)
Potential<br>仰る	仰れる<br>(S3)
Passive<br>仰る	仰られる<br>(S3)
Causative<br>仰る	仰らせる<br>(S3)
Imperative<br>仰る	仰って<br>(S3)
Conditional<br>仰る	仰れば<br>(S3)
Present Positive Plain<br>だ	だ<br>(T1)
Present Negative Plain<br>だ	ではない<br>(T1)
Present Positive Polite<br>だ	です<br>(T1)
Present Negative Polite<br>だ	ではありません<br>(T1)
Past Positive Plain<br>だ	だった<br>(T1)
Past Negative Plain<br>だ	ではなかった<br>(T1)
Past Positive Polite<br>だ	でした<br>(T1)
Past Negative Polite<br>だ	ではありませんでした<br>(T1)
-te Form<br>だ	で<br>(T1)
Volitional<br>だ	だろう<br>(T1)
Potential<br>だ	できる<br>(T1)
Passive<br>だ	される<br>(T1)
Causative<br>だ	させる<br>(T1)
Imperative<br>だ	だろ<br>(T1)
Conditional<br>だ	なら<br>(T1)
Present Positive Plain<br>する	する<br>(U1)
Present Negative Plain<br>する	しない<br>(U1)
Present Positive Polite<br>する	します<br>(U1)
Present Negative Polite<br>する	しません<br>(U1)
Past Positive Plain<br>する	した<br>(U1)
Past Negative Plain<br>する	しなかった<br>(U1)
Past Positive Polite<br>する	しました<br>(U1)
Past Negative Polite<br>する	しませんでした<br>(U1)
-te Form<br>する	して<br>(U1)
Volitional<br>する	しよう<br>(U1)
Potential<br>する	できる<br>(U1)
Passive<br>する	される<br>(U1)
Causative<br>する	させる<br>(U1)
Imperative<br>する	しろ<br>(U1)
Conditional<br>する	すれば<br>(U1)
Present Positive Plain<br>使用する	使用する<br>(U2)
Present Negative Plain<br>使用する	使用しない<br>(U2)
Present Positive Polite<br>使用する	使用します<br>(U2)
Present Negative Polite<br>使用する	使用しません<br>(U2)
Past Positive Plain<br>使用する	使用した<br>(U2)
Past Negative Plain<br>使用する	使用しなかった<br>(U2)
Past Positive Polite<br>使用する	使用しました<br>(U2)
Past Negative Polite<br>使用する	使用しませんでした<br>(U2)
-te Form<br>使用する	使用して<br>(U2)
Volitional<br>使用する	使用しよう<br>(U2)
Potential<br>使用する	使用できる<br>(U2)
Passive<br>使用する	使用される<br>(U2)
Causative<br>使用する	使用させる<br>(U2)
Imperative<br>使用する	使用しろ<br>(U2)
Conditional<br>使用する	使用すれば<br>(U2)
Present Positive Plain<br>表示する	表示する<br>(U3)
Present Negative Plain<br>表示する	表示しない<br>(U3)
Present Positive Polite<br>表示する	表示します<br>(U3)
Present Negative Polite<br>表示する	表示しません<br>(U3)
Past Positive Plain<br>表示する	表示した<br>(U3)
Past Negative Plain<br>表示する	表示しなかった<br>(U3)
Past Positive Polite<br>表示する	表示しました<br>(U3)
Past Negative Polite<br>表示する	表示しませんでした<br>(U3)
-te Form<br>表示する	表示して<br>(U3)
Volitional<br>表示する	表示しよう<br>(U3)
Potential<br>表示する	表示できる<br>(U3)
Passive<br>表示する	表示される<br>(U3)
Causative<br>表示する	表示させる<br>(U3)
Imperative<br>表示する	表示しろ<br>(U3)
Conditional<br>表示する	表示すれば<br>(U3)
Present Positive Plain<br>くれる	くれる<br>(V1)
Present Negative Plain<br>くれる	くれない<br>(V1)
Present Positive Polite<br>くれる	くれます<br>(V1)
Present Negative Polite<br>くれる	くれません<br>(V1)
Past Positive Plain<br>くれる	くれた<br>(V1)
Past Negative Plain<br>くれる	くれなかった<br>(V1)
Past Positive Polite<br>くれる	くれました<br>(V1)
Past Negative Polite<br>くれる	くれませんでした<br>(V1)
-te Form<br>くれる	くれて<br>(V1)
Volitional<br>くれる	くれよう<br>(V1)
Potential<br>くれる	くれる<br>(V1)
Passive<br>くれる	くれられる<br>(V1)
Causative<br>くれる	くれさせる<br>(V1)
Imperative<br>くれる	くれ<br>(V1)
Conditional<br>くれる	くれれば<br>(V1)
Present Positive Plain<br>呉れる	呉れる<br>(V2)
Present Negative Plain<br>呉れる	呉れない<br>(V2)
Present Positive Polite<br>呉れる	呉れます<br>(V2)
Present Negative Polite<br>呉れる	呉れません<br>(V2)
Past Positive Plain<br>呉れる	呉れた<br>(V2)
Past Negative Plain<br>呉れる	呉れなかった<br>(V2)
Past Positive Polite<br>呉れる	呉れました<br>(V2)
Past Negative Polite<br>呉れる	呉れませんでした<br>(V2)
-te Form<br>呉れる	呉れて<br>(V2)
Volitional<br>呉れる	呉れよう<br>(V2)
Potential<br>呉れる	呉れる<br>(V2)
Passive<br>呉れる	呉れられる<br>(V2)
Causative<br>呉れる	呉れさせる<br>(V2)
Imperative<br>呉れる	呉れ<br>(V2)
Conditional<br>呉れる	呉れれば<br>(V2)
Present Positive Plain<br>ある	ある<br>(W1)
Present Negative Plain<br>ある	ない<br>(W1)
Present Positive Polite<br>ある	あります<br>(W1)
Present Negative Polite<br>ある	ありません<br>(W1)
Past Positive Plain<br>ある	あった<br>(W1)
Past Negative Plain<br>ある	なかった<br>(W1)
Past Positive Polite<br>ある	ありました<br>(W1)
Past Negative Polite<br>ある	ありませんでした<br>(W1)
-te Form<br>ある	あって<br>(W1)
Volitional<br>ある	あろう<br>(W1)
Potential<br>ある	ありえる<br>(W1)
Passive<br>ある	ありえる<br>(W1)
Causative<br>ある	あらせる<br>(W1)
Imperative<br>ある	あれ<br>(W1)
Conditional<br>ある	あれば<br>(W1)